municipio;cluster;uf;pessoas;mortos;feridos_leves;feridos_graves;ilesos;feridos;freq
abadia de goias;3;uf;1502;26;391;184;850;575;786
abadiania;5;uf;3271;117;902;520;1637;1422;1656
abare;4;uf;339;32;74;55;149;129;142
abatia;4;uf;4;0;2;0;1;2;2
abel figueiredo;4;uf;71;12;17;18;16;35;23
abre campo;3;uf;1029;31;281;171;513;452;446
abreu e lima;3;uf;5814;52;589;268;4623;857;2621
abreulandia;4;uf;1;0;0;0;1;0;1
acailandia;5;uf;5515;285;1494;789;2487;2283;2283
acarape;4;uf;17;0;2;0;14;2;4
acarau;4;uf;15;3;1;4;4;5;5
acari;4;uf;398;24;101;60;193;161;207
acaua;4;uf;81;11;20;13;33;33;45
acegua;4;uf;160;6;24;9;108;33;78
acrelandia;4;uf;247;7;70;22;145;92;104
acreuna;3;uf;1808;76;494;154;1010;648;822
acu;4;uf;122;6;39;16;53;55;47
adrianopolis;4;uf;228;9;66;44;99;110;111
afonso claudio;4;uf;1;0;1;0;0;1;1
afranio;4;uf;173;14;41;30;76;71;87
agrestina;3;uf;1012;57;260;157;463;417;406
agricolandia;4;uf;9;0;3;0;5;3;7
agronomica;3;uf;1402;57;382;109;809;491;609
agua boa;3;uf;1431;43;422;136;802;558;637
agua boa;3;uf;1431;43;422;136;802;558;637
agua branca;4;uf;420;41;107;59;188;166;184
agua branca;4;uf;420;41;107;59;188;166;184
agua clara;3;uf;1838;32;414;139;1224;553;777
agua doce;4;uf;1080;38;294;91;644;385;534
agua fria de goias;4;uf;4;0;4;0;0;4;2
agua preta;4;uf;121;7;36;6;66;42;67
agua santa;4;uf;64;2;17;6;38;23;30
aguas belas;4;uf;444;41;97;54;227;151;186
aguas lindas de goias;5;uf;4994;139;1341;543;2591;1884;2093
aguas mornas;3;uf;3143;77;906;331;1771;1237;1520
aguas vermelhas;4;uf;85;1;23;6;49;29;31
aguiarnopolis;4;uf;661;14;129;66;414;195;288
aimores;4;uf;124;10;46;22;44;68;61
aiquara;4;uf;1;0;1;0;0;1;1
aiuruoca;4;uf;365;27;133;44;159;177;204
alagoinha do piaui;4;uf;20;3;2;2;12;4;11
alagoinhas;5;uf;3802;172;1048;347;2029;1395;1723
alcantil;4;uf;278;17;67;48;133;115;145
alcinopolis;4;uf;99;4;30;13;48;43;47
alcobaca;4;uf;2;0;0;1;1;1;1
alegre;4;uf;32;1;12;6;13;18;11
alegrete;3;uf;1648;35;381;107;1040;488;618
alegrete do piaui;4;uf;154;5;27;22;90;49;84
alem paraiba;3;uf;1554;66;412;150;881;562;790
alexania;5;uf;3578;110;943;397;1906;1340;1931
alfredo chaves;4;uf;26;0;2;1;19;3;15
alfredo vasconcelos;3;uf;982;43;333;118;468;451;450
alfredo wagner;3;uf;2289;70;816;251;1103;1067;1201
algodao de jandaira;4;uf;70;6;18;12;31;30;32
alhandra;3;uf;2179;43;573;224;1202;797;1173
alianca;4;uf;237;20;57;31;112;88;97
alianca do tocantins;3;uf;874;55;233;116;451;349;352
almino afonso;4;uf;10;5;0;3;1;3;3
almirante tamandare do sul;4;uf;790;23;189;44;521;233;319
alpercata;4;uf;730;30;240;103;341;343;345
altamira;3;uf;1087;48;398;90;498;488;435
altinho;4;uf;2;0;0;0;1;0;1
alto alegre do maranhao;4;uf;524;45;111;76;277;187;221
alto araguaia;3;uf;1566;36;310;71;1133;381;780
alto boa vista;4;uf;14;3;2;3;2;5;5
alto garcas;3;uf;2002;45;367;105;1456;472;1021
alto horizonte;4;uf;5;2;1;1;1;2;3
alto paraiso;4;uf;1019;42;245;60;612;305;370
alto paraiso;4;uf;1019;42;245;60;612;305;370
alto parana;3;uf;1226;41;362;119;656;481;546
alto santo;4;uf;407;21;78;42;251;120;164
altos;3;uf;1657;101;330;260;881;590;779
alvorada;3;uf;1130;61;302;170;574;472;422
alvorada do gurgueia;4;uf;163;17;78;6;60;84;46
alvorada do norte;3;uf;1601;81;460;192;826;652;642
alvorada doeste;4;uf;66;6;19;14;25;33;29
amajari;4;uf;268;18;69;23;139;92;89
amapa;4;uf;37;3;5;1;11;6;11
amapa do maranhao;4;uf;1;0;0;0;1;0;1
amaraji;4;uf;7;2;1;0;2;1;5
amaralina;4;uf;3;0;2;0;1;2;1
amarante;4;uf;723;50;191;96;345;287;347
amargosa;4;uf;3;0;2;0;1;2;1
amelia rodrigues;5;uf;5139;79;985;226;3587;1211;2493
amontada;4;uf;35;4;14;7;9;21;9
amparo de sao francisco;4;uf;6;0;0;1;5;1;2
anajas;4;uf;2;0;1;0;0;1;1
anajatuba;4;uf;20;1;1;1;17;2;10
ananindeua;1;uf;25905;174;3258;1165;20163;4423;11418
anapolis;1;uf;13309;217;3078;1504;7892;4582;6356
anapu;4;uf;192;16;35;17;116;52;87
anastacio;3;uf;1294;29;297;164;779;461;560
anaurilandia;4;uf;2;1;0;0;0;0;2
anchieta;3;uf;2014;93;497;186;1169;683;1008
anchieta;3;uf;2014;93;497;186;1169;683;1008
andarai;4;uf;51;3;14;2;22;16;23
andira;4;uf;818;22;187;84;495;271;346
andradas;4;uf;365;13;166;43;133;209;211
andre da rocha;4;uf;4;0;1;1;2;2;3
angical;4;uf;6;0;0;0;5;0;1
angical do piaui;4;uf;180;19;30;48;75;78;82
angicos;3;uf;643;61;182;86;281;268;272
angra dos reis;1;uf;11214;223;2817;944;6946;3761;4922
antas;4;uf;353;23;120;45;148;165;129
antonina;4;uf;1283;6;369;75;810;444;691
antonio cardoso;3;uf;1413;46;239;93;961;332;551
antonio dias;5;uf;3740;112;1204;367;1997;1571;1726
antonio martins;4;uf;15;3;3;1;7;4;8
antonio olinto;4;uf;317;17;92;18;179;110;167
aparecida;5;uf;4481;80;1083;275;2826;1358;2244
aparecida;5;uf;4481;80;1083;275;2826;1358;2244
aparecida de goiania;1;uf;12846;145;2332;1205;8552;3537;5720
aparecida do rio doce;4;uf;299;10;77;33;165;110;138
aparecida do taboado;3;uf;1043;54;299;162;504;461;429
apiaca;4;uf;1;0;0;0;1;0;1
apiuna;5;uf;4166;89;1005;313;2623;1318;1841
apodi;4;uf;323;36;67;63;129;130;145
apucarana;5;uf;6113;81;1802;559;3367;2361;2685
apui;4;uf;1;0;0;0;1;0;1
aquidaba;4;uf;3;0;0;0;3;0;1
aquidauana;4;uf;141;6;40;25;65;65;76
aquiraz;4;uf;762;36;209;98;364;307;369
aracaju;3;uf;2594;30;482;100;1844;582;1110
aracati;3;uf;1921;56;407;154;1228;561;837
araci;4;uf;374;39;98;39;174;137;168
aracruz;3;uf;2329;89;613;263;1244;876;1053
aragarcas;4;uf;573;45;176;72;259;248;236
aragoiania;4;uf;2;0;0;0;2;0;1
araguaiana;4;uf;1;1;0;0;0;0;1
araguaina;5;uf;4347;126;1047;591;2366;1638;1907
araguana;4;uf;176;18;43;20;87;63;87
araguari;5;uf;4125;89;1222;412;2287;1634;2228
araguatins;4;uf;30;3;5;10;8;15;14
aramari;4;uf;43;3;21;3;15;24;13
arambare;4;uf;29;1;3;0;23;3;18
arame;4;uf;4;0;0;0;4;0;2
arantina;4;uf;68;3;28;9;27;37;32
arapiraca;4;uf;1;0;0;0;1;0;1
arapongas;5;uf;4035;83;1109;420;2215;1529;1771
arapora;3;uf;1382;36;337;111;878;448;646
arapoti;4;uf;5;0;5;0;0;5;3
arapua;4;uf;2;0;2;0;0;2;1
araquari;1;uf;10900;184;2404;890;7149;3294;5041
ararangua;5;uf;6216;109;1737;340;3850;2077;2886
arari;4;uf;287;25;60;47;131;107;114
araripina;3;uf;765;98;182;139;273;321;304
araruama;4;uf;1;0;1;0;0;1;1
araruna;4;uf;163;10;52;35;61;87;61
arataca;3;uf;1698;71;408;123;1051;531;934
araucaria;3;uf;3570;59;806;266;2263;1072;1558
araujos;4;uf;483;14;121;52;286;173;204
araxa;3;uf;1503;56;354;143;913;497;703
arcoverde;3;uf;1772;97;311;322;934;633;843
areal;3;uf;2288;37;456;103;1662;559;1245
areia branca;3;uf;1555;77;412;166;777;578;671
areia branca;3;uf;1555;77;412;166;777;578;671
ares;4;uf;381;7;102;21;236;123;199
argirita;4;uf;613;11;185;55;343;240;338
arinos;4;uf;1;0;0;0;1;0;1
ariquemes;5;uf;5645;165;1170;392;3707;1562;2083
aroeiras;4;uf;3;0;1;1;1;2;2
arroio dos ratos;4;uf;905;23;213;92;545;305;369
arroio grande;4;uf;738;13;186;47;478;233;336
aruja;3;uf;4048;74;665;115;2907;780;1927
ascurra;3;uf;1520;24;476;161;804;637;678
assai;4;uf;4;0;0;2;2;2;3
assis brasil;4;uf;25;3;6;0;16;6;5
assu;4;uf;997;40;208;71;595;279;451
assuncao;4;uf;58;4;10;3;28;13;21
assuncao do piaui;4;uf;8;0;8;0;0;8;2
atalaia;3;uf;1759;83;432;282;838;714;778
atalaia;3;uf;1759;83;432;282;838;714;778
ataleia;4;uf;1;0;1;0;0;1;1
atibaia;5;uf;9264;206;2041;460;6149;2501;4363
atilio vivacqua;4;uf;1011;35;271;108;545;379;540
augusto correa;4;uf;7;0;2;1;4;3;4
augusto de lima;3;uf;1050;45;282;159;533;441;437
augusto severo;4;uf;32;2;14;6;10;20;15
aurelino leal;4;uf;735;29;185;42;454;227;361
aurora;4;uf;24;0;0;0;24;0;1
aurora do para;4;uf;448;23;123;55;223;178;186
axixa;4;uf;45;6;7;10;18;17;22
bacabal;3;uf;1428;95;315;220;708;535;648
bacabeira;3;uf;3609;152;411;373;2509;784;1433
bady bassitt;4;uf;1126;25;293;68;697;361;531
baependi;4;uf;644;27;243;59;301;302;341
bage;4;uf;1677;19;337;99;1184;436;904
baia formosa;4;uf;71;1;17;8;42;25;35
baianopolis;4;uf;16;1;3;0;10;3;8
baixa grande;4;uf;5;0;1;2;2;3;3
baixio;4;uf;79;5;13;12;45;25;30
baixo guandu;4;uf;551;31;149;141;211;290;249
balneario barra do sul;4;uf;22;0;12;1;9;13;7
balneario camboriu;1;uf;12049;131;3119;592;7766;3711;5937
balneario picarras;4;uf;239;5;86;18;119;104;119
balsa nova;5;uf;5148;57;973;225;3735;1198;2373
balsas;3;uf;2211;95;631;255;1094;886;980
banabuiu;4;uf;1;0;0;0;1;0;1
bandeira;4;uf;1;0;0;1;0;1;1
bandeira do sul;4;uf;358;14;111;45;177;156;169
bandeirantes;3;uf;3600;103;863;360;2152;1223;1536
bandeirantes;3;uf;3600;103;863;360;2152;1223;1536
barao;4;uf;110;1;32;7;61;39;49
barao de cocais;4;uf;715;26;198;84;394;282;316
barao de cotegipe;4;uf;232;2;64;18;136;82;122
barao de grajau;4;uf;674;28;175;175;252;350;353
barao do triunfo;4;uf;4;0;0;0;4;0;2
barbacena;5;uf;3996;82;1303;318;2189;1621;2276
barbosa ferraz;4;uf;3;0;0;1;2;1;1
barra;4;uf;6;0;0;0;6;0;2
barra de santa rosa;4;uf;142;15;45;30;46;75;56
barra de santana;4;uf;327;17;103;34;156;137;156
barra de sao miguel;4;uf;4;0;0;0;3;0;3
barra do choca;4;uf;2;0;0;0;2;0;1
barra do corda;4;uf;147;15;24;19;78;43;74
barra do garcas;5;uf;4032;91;1208;374;2228;1582;1833
barra do mendes;4;uf;3;0;3;0;0;3;1
barra do pirai;5;uf;4446;100;876;328;2988;1204;2127
barra do quarai;4;uf;109;1;39;15;49;54;52
barra do ribeiro;3;uf;1889;56;336;153;1306;489;784
barra do rocha;4;uf;119;9;37;17;52;54;49
barra do sul;4;uf;6;0;1;0;5;1;3
barra do turvo;1;uf;12519;127;1989;371;9846;2360;8695
barra funda;4;uf;7;0;2;0;5;2;4
barra mansa;1;uf;11961;145;1974;451;8878;2425;6080
barra velha;5;uf;4748;82;1064;372;3105;1436;2288
barracao;3;uf;1408;32;343;133;838;476;591
barracao;3;uf;1408;32;343;133;838;476;591
barreiras;5;uf;5653;244;1479;334;3354;1813;2046
barreirinhas;4;uf;11;1;3;3;2;6;3
barro;4;uf;829;45;179;99;466;278;352
barro alto;4;uf;433;25;118;74;203;192;186
barro duro;4;uf;272;26;87;49;98;136;111
barro preto;4;uf;8;0;1;4;3;5;3
barrolandia;4;uf;686;33;156;100;367;256;245
barueri;4;uf;2;0;0;0;1;0;1
bataguassu;3;uf;2385;82;570;189;1462;759;1092
batalha;4;uf;1;0;0;0;1;0;1
bayeux;5;uf;7562;35;1159;347;5619;1506;3133
beberibe;4;uf;168;16;50;17;70;67;88
bela vista;4;uf;208;13;75;35;79;110;95
bela vista de minas;3;uf;2890;62;930;366;1489;1296;1408
bela vista do maranhao;4;uf;303;24;58;38;151;96;139
bela vista do toldo;4;uf;1;0;1;0;0;1;1
belem;3;uf;5286;39;358;124;4584;482;2477
belem;3;uf;5286;39;358;124;4584;482;2477
belem de maria;4;uf;1;0;1;0;0;1;1
belem de sao francisco;3;uf;950;48;277;83;507;360;436
belford roxo;4;uf;2536;13;249;28;2080;277;1110
belmonte;4;uf;2;0;0;0;2;0;1
belo horizonte;5;uf;7846;62;1050;538;5980;1588;3517
belo jardim;3;uf;1625;81;381;210;833;591;608
belo oriente;3;uf;1710;49;386;120;1117;506;793
belterra;4;uf;206;19;62;49;53;111;83
benevides;3;uf;3785;77;773;308;2417;1081;1681
bento goncalves;4;uf;1169;12;324;61;701;385;501
bertolinia;4;uf;55;13;8;14;19;22;23
beruri;4;uf;1;0;1;0;0;1;1
betim;2;uf;39527;329;6840;1718;29551;8558;17601
bezerros;3;uf;2474;103;586;263;1353;849;1144
bicas;4;uf;911;23;300;96;468;396;441
biguacu;1;uf;11083;120;3071;824;6664;3895;5762
blumenau;1;uf;16670;122;3296;755;12031;4051;7405
boa esperanca;4;uf;2;0;1;0;1;1;2
boa esperanca;4;uf;2;0;1;0;1;1;2
boa nova;4;uf;527;28;123;22;334;145;258
boa viagem;3;uf;907;46;284;154;378;438;413
boa vista;5;uf;7019;161;2091;560;3837;2651;2805
boa vista;5;uf;7019;161;2091;560;3837;2651;2805
boa vista das missoes;4;uf;755;33;190;47;476;237;328
boa vista do burica;4;uf;136;7;60;14;53;74;56
boa vista do gurupi;4;uf;96;8;23;19;44;42;44
boa vista do tupim;4;uf;230;18;78;22;100;100;82
boca da mata;4;uf;1;0;1;0;0;1;1
boca do acre;4;uf;30;3;12;2;10;14;12
bocaina do sul;3;uf;1505;53;472;163;789;635;767
bocaiuva;3;uf;2792;124;784;363;1455;1147;1242
bocaiuva do sul;4;uf;1070;24;315;179;499;494;493
bodoco;4;uf;26;3;4;9;10;13;12
bom despacho;3;uf;2114;73;518;208;1287;726;891
bom jardim;4;uf;355;30;81;60;167;141;162
bom jardim de goias;4;uf;320;22;86;53;153;139;127
bom jardim de minas;4;uf;395;31;159;43;158;202;194
bom jesus;3;uf;1233;67;374;131;613;505;541
bom jesus;3;uf;1233;67;374;131;613;505;541
bom jesus;3;uf;1233;67;374;131;613;505;541
bom jesus;3;uf;1233;67;374;131;613;505;541
bom jesus da penha;4;uf;2;0;0;0;2;0;1
bom jesus das selvas;3;uf;535;72;186;90;138;276;169
bom jesus de goias;3;uf;860;56;232;134;411;366;378
bom jesus do amparo;3;uf;2832;75;522;357;1841;879;1248
bom jesus do araguaia;4;uf;80;15;17;7;35;24;30
bom jesus do galho;4;uf;2;0;0;0;2;0;1
bom jesus do itabapoana;4;uf;4;0;2;0;2;2;2
bom jesus do sul;4;uf;193;10;48;18;112;66;81
bom jesus do tocantins;4;uf;118;9;36;10;50;46;44
bom lugar;4;uf;6;0;0;3;3;3;3
bom principio;4;uf;2;0;0;0;2;0;1
bom principio do piaui;4;uf;18;0;8;4;5;12;8
bom progresso;4;uf;264;11;86;33;127;119;85
bom retiro;3;uf;1489;55;508;188;688;696;664
bom retiro do sul;4;uf;228;2;54;11;155;65;103
bom sucesso;4;uf;231;5;82;46;93;128;93
bom sucesso do sul;4;uf;2;0;1;0;1;1;1
bonfim;4;uf;278;25;101;36;96;137;95
boninal;4;uf;20;1;7;1;11;8;8
bonito;4;uf;151;4;35;34;73;69;61
bonopolis;4;uf;3;1;2;0;0;2;1
boqueirao do piaui;4;uf;5;1;0;3;0;3;1
bossoroca;4;uf;20;0;3;4;13;7;8
botelhos;4;uf;310;8;128;35;132;163;149
bozano;4;uf;568;16;123;46;374;169;254
braco do trombudo;4;uf;2;0;0;0;2;0;1
braganca;4;uf;338;25;84;61;144;145;150
braganca paulista;3;uf;2705;45;628;140;1789;768;1375
branquinha;4;uf;506;45;145;100;186;245;211
brasil novo;4;uf;219;23;56;30;102;86;91
brasilandia;4;uf;309;5;137;27;132;164;142
brasilandia do tocantins;4;uf;529;38;110;48;320;158;221
brasileia;4;uf;87;3;36;10;34;46;33
brasileira;4;uf;434;21;106;41;254;147;212
brasilia;2;uf;36378;621;10589;2646;20608;13235;14992
brasnorte;4;uf;3;0;0;0;3;0;1
brejao;4;uf;6;1;2;1;2;3;3
brejetuba;4;uf;305;10;74;52;153;126;160
brejo grande do araguaia;4;uf;47;6;11;5;24;16;23
brejo santo;3;uf;1034;66;224;149;534;373;390
brejoes;4;uf;858;28;157;36;610;193;362
brotas de macaubas;4;uf;2;0;1;0;1;1;1
brumadinho;3;uf;3346;80;785;207;2166;992;1827
brunopolis;4;uf;609;36;196;61;304;257;282
brusque;4;uf;4;0;1;0;3;1;2
buenopolis;4;uf;608;24;177;111;276;288;269
buenos aires;4;uf;9;1;1;3;4;4;5
buerarema;4;uf;723;31;170;86;401;256;313
buique;4;uf;12;1;1;3;7;4;5
bujari;4;uf;641;27;183;94;306;277;223
buriti alegre;4;uf;1;0;0;0;1;0;1
buriti bravo;4;uf;1;0;0;0;1;0;1
buriti dos lopes;4;uf;803;46;217;117;381;334;409
buriticupu;4;uf;243;33;41;47;101;88;129
buritizeiro;3;uf;1542;91;582;219;606;801;660
butia;4;uf;1034;38;212;124;635;336;455
caapora;3;uf;1680;30;384;132;1069;516;956
caarapo;3;uf;1499;30;395;115;918;510;657
cabeceira grande;4;uf;1;0;1;0;0;1;1
cabeceiras;4;uf;1;0;1;0;0;1;1
cabedelo;5;uf;6420;67;1262;473;4161;1735;2941
cabo de santo agostinho;5;uf;7575;189;1424;577;4857;2001;3605
cabo verde;4;uf;399;14;149;63;163;212;194
cabrobo;3;uf;919;44;265;130;431;395;390
cacador;4;uf;1;0;1;0;0;1;1
cacapava;5;uf;5596;77;1003;203;3908;1206;2441
cacapava do sul;3;uf;2019;51;459;158;1305;617;1174
cacaulandia;4;uf;95;2;21;5;63;26;42
cacequi;4;uf;14;1;0;2;11;2;7
caceres;5;uf;5584;181;1454;674;3130;2128;2867
cachoeira;4;uf;370;17;70;41;229;111;170
cachoeira alta;3;uf;1151;60;286;111;664;397;504
cachoeira de minas;4;uf;4;0;0;4;0;4;1
cachoeira de pajeu;3;uf;1094;67;195;87;711;282;512
cachoeira do piria;4;uf;329;18;82;51;158;133;159
cachoeira do sul;3;uf;1582;90;402;147;919;549;689
cachoeira dos indios;4;uf;197;16;38;31;102;69;101
cachoeira dourada;4;uf;2;0;0;0;2;0;1
cachoeira paulista;3;uf;1838;21;368;77;1282;445;975
cachoeirinha;3;uf;1000;64;222;92;567;314;470
cachoeirinha;3;uf;1000;64;222;92;567;314;470
cachoeirinha;3;uf;1000;64;222;92;567;314;470
cachoeiro de itapemirim;3;uf;1537;38;460;251;686;711;698
cacimbinhas;4;uf;317;31;60;58;137;118;137
cacoal;5;uf;5260;65;1683;509;2833;2192;2411
cacu;4;uf;47;2;9;2;33;11;18
caem;4;uf;76;6;19;6;42;25;33
caetanopolis;3;uf;1738;43;452;142;1048;594;826
caete;5;uf;4431;109;951;646;2649;1597;1948
caetes;3;uf;697;62;158;124;290;282;282
caetite;4;uf;1;0;1;0;0;1;1
cafelandia;4;uf;4;0;1;0;3;1;2
caiaponia;4;uf;689;45;189;80;360;269;336
caibate;4;uf;268;7;98;13;150;111;56
caibi;4;uf;295;21;67;38;160;105;145
caicara do norte;4;uf;1;0;0;0;1;0;1
caicara do rio do vento;4;uf;297;21;86;33;138;119;134
caico;4;uf;1021;15;304;189;451;493;466
cajati;5;uf;9232;149;1598;360;6906;1958;6016
cajazeiras;3;uf;1190;68;324;193;519;517;592
cajueiro;4;uf;4;0;3;0;1;3;1
cajueiro da praia;4;uf;10;2;1;1;4;2;6
calcado;4;uf;75;6;21;8;36;29;36
calcoene;4;uf;116;14;31;21;42;52;40
caldas;3;uf;1147;49;348;149;568;497;617
caldas brandao;4;uf;498;14;92;66;289;158;238
caldeirao grande;4;uf;90;6;22;11;45;33;27
caldeirao grande do piaui;4;uf;1;0;0;0;1;0;1
california;4;uf;711;34;159;79;407;238;312
calumbi;4;uf;157;14;60;21;57;81;68
camacan;3;uf;1360;55;293;115;864;408;682
camacari;4;uf;2;0;1;0;1;1;2
camalau;4;uf;2;2;0;0;0;0;1
camamu;4;uf;26;3;6;2;13;8;15
camanducaia;3;uf;3081;43;829;205;1895;1034;1811
camapua;4;uf;752;33;237;90;371;327;351
camaqua;3;uf;2044;54;425;186;1307;611;1036
camaragibe;4;uf;2;0;0;0;2;0;2
cambara;4;uf;913;23;237;103;529;340;388
cambe;3;uf;4180;54;717;248;2997;965;1635
cambira;4;uf;465;15;146;53;238;199;212
camboriu;4;uf;42;0;20;2;19;22;22
cambui;5;uf;4558;76;1126;294;2901;1420;2770
cambuquira;4;uf;791;41;217;73;433;290;378
camocim;4;uf;5;0;2;0;3;2;1
campanario;3;uf;946;51;247;118;506;365;420
campanha;5;uf;3601;93;1229;297;1907;1526;1898
campestre;4;uf;452;8;137;50;244;187;209
campestre da serra;4;uf;871;23;230;71;532;301;477
campestre do maranhao;4;uf;476;27;111;72;231;183;215
campina da lagoa;4;uf;6;1;1;1;2;2;4
campina grande;5;uf;6197;160;1452;612;3671;2064;3068
campina grande do sul;1;uf;14340;156;3598;723;9530;4321;8655
campinas;4;uf;1;0;0;0;1;0;1
campinorte;3;uf;1791;70;383;213;1065;596;670
campo alegre;4;uf;295;21;66;37;152;103;112
campo alegre de goias;3;uf;1847;83;418;184;1122;602;717
campo bom;4;uf;4;0;2;0;2;2;1
campo bonito;4;uf;92;3;23;11;51;34;37
campo do tenente;4;uf;916;35;225;102;535;327;476
campo florido;4;uf;750;28;219;92;386;311;370
campo grande;1;uf;10013;296;2222;1098;5989;3320;4231
campo grande;1;uf;10013;296;2222;1098;5989;3320;4231
campo grande do piaui;4;uf;210;18;42;46;94;88;98
campo largo;5;uf;7744;105;1470;401;5345;1871;3392
campo maior;3;uf;1725;82;345;239;996;584;941
campo mourao;5;uf;4294;101;1044;505;2471;1549;1949
campo novo;4;uf;229;17;85;23;104;108;92
campo novo do parecis;4;uf;37;1;6;2;26;8;13
campo redondo;4;uf;367;23;88;54;187;142;162
campo verde;3;uf;2293;56;443;221;1529;664;1062
campos altos;3;uf;2637;83;796;219;1517;1015;1357
campos de julio;4;uf;66;5;16;11;32;27;30
campos dos goytacazes;1;uf;19919;631;5084;1337;12049;6421;8855
campos novos;5;uf;3554;120;965;316;2032;1281;1531
campos novos paulista;4;uf;146;6;18;8;109;26;74
canabrava do norte;4;uf;23;1;4;2;15;6;9
cananeia;4;uf;2;0;0;0;2;0;1
canapi;4;uf;446;13;101;67;245;168;190
canapolis;4;uf;706;24;179;65;425;244;400
canarana;4;uf;344;15;107;45;170;152;191
canas;4;uf;929;19;170;59;637;229;458
canavieira;4;uf;1;0;0;0;1;0;1
candeal;4;uf;97;14;35;11;33;46;33
candeias;5;uf;5324;103;1388;227;3349;1615;2499
candeias do jamari;3;uf;2184;85;571;184;1249;755;888
candido sales;4;uf;1043;47;192;69;693;261;438
candiota;4;uf;289;6;50;21;203;71;139
candoi;3;uf;2160;103;628;244;1131;872;962
canelinha;4;uf;6;0;2;0;4;2;3
canguaretama;4;uf;757;37;156;82;448;238;381
cangucu;3;uf;1299;56;315;104;779;419;652
caninde;3;uf;1376;62;363;204;683;567;584
canoas;1;uf;23395;104;2615;504;19617;3119;10576
canoinhas;4;uf;1012;13;309;86;565;395;458
canta;4;uf;859;43;304;86;343;390;317
cantagalo;4;uf;823;28;243;99;428;342;397
canudos;4;uf;534;44;157;47;269;204;213
canutama;4;uf;192;16;73;33;58;106;73
capanema;3;uf;1752;84;428;252;888;680;799
capanema;3;uf;1752;84;428;252;888;680;799
capao alto;3;uf;1822;54;443;151;1136;594;931
capao bonito do sul;4;uf;207;5;55;27;118;82;98
capao do leao;3;uf;2123;50;502;170;1317;672;1026
capela;3;uf;1211;45;223;95;791;318;466
capim;4;uf;4;0;1;1;1;2;3
capim branco;4;uf;97;0;26;14;55;40;52
capim grosso;3;uf;1263;49;261;154;710;415;489
capinzal do norte;4;uf;196;27;48;17;95;65;82
capitao de campos;4;uf;303;18;55;33;182;88;130
capitao leonidas marques;4;uf;995;34;215;69;640;284;409
capivari de baixo;3;uf;2016;18;565;146;1234;711;961
capivari do sul;4;uf;3;0;0;1;2;1;1
capixaba;4;uf;418;20;124;47;211;171;151
capoeiras;4;uf;5;0;1;1;3;2;3
caracarai;4;uf;398;43;88;47;141;135;117
caracol;4;uf;52;4;19;10;17;29;25
carai;3;uf;811;50;303;100;329;403;315
carandai;3;uf;2834;103;852;263;1522;1115;1306
carapebus;4;uf;477;21;100;38;303;138;221
caratinga;5;uf;5587;73;1630;609;3093;2239;2726
caraubas do piaui;4;uf;117;4;52;8;45;60;56
caravelas;3;uf;1318;64;286;179;741;465;515
carazinho;3;uf;3225;47;642;180;2296;822;1399
cardoso moreira;4;uf;793;37;282;61;402;343;415
careacu;3;uf;2204;52;738;140;1203;878;1199
careiro;4;uf;251;23;73;23;100;96;95
careiro da varzea;4;uf;256;7;54;15;165;69;97
cariacica;2;uf;28936;182;4060;2257;20983;6317;13508
caridade;4;uf;993;29;270;121;538;391;436
caridade do piaui;4;uf;1;0;0;0;1;0;1
carira;4;uf;271;30;66;64;68;130;117
cariri do tocantins;3;uf;986;52;252;138;512;390;441
carlos barbosa;4;uf;178;3;62;13;95;75;85
carmo;4;uf;110;1;20;7;79;27;44
carmo da cachoeira;5;uf;4564;53;1122;171;3131;1293;2919
carmo de minas;4;uf;343;8;126;47;158;173;146
carmopolis;4;uf;574;17;122;51;338;173;226
carmopolis de minas;3;uf;3163;68;750;168;2098;918;1738
caroebe;4;uf;2;1;1;0;0;1;1
carolina;4;uf;292;46;66;38;106;104;121
carpina;4;uf;773;27;166;81;453;247;323
caruaru;1;uf;10801;296;2226;869;6806;3095;4804
carvalhos;4;uf;69;1;33;5;27;38;45
casa nova;4;uf;3;0;1;0;2;1;2
cascalho rico;4;uf;1;0;0;0;1;0;1
cascavel;1;uf;17310;324;4524;1461;10446;5985;7819
cascavel;1;uf;17310;324;4524;1461;10446;5985;7819
caseiros;4;uf;532;21;137;33;328;170;260
casimiro de abreu;5;uf;5166;149;816;337;3732;1153;2284
cassilandia;4;uf;693;22;181;105;358;286;286
castanhal;5;uf;6211;127;1010;572;4171;1582;2698
castelandia;4;uf;41;1;17;2;21;19;22
castelo;4;uf;4;0;1;1;2;2;1
castilho;4;uf;21;0;6;1;14;7;14
castro alves;4;uf;10;0;0;0;10;0;5
cataguases;4;uf;2;0;0;0;2;0;1
catalao;5;uf;4682;111;854;362;3251;1216;1658
catanduvas;4;uf;1234;30;358;96;719;454;601
catanduvas;4;uf;1234;30;358;96;719;454;601
catingueira;4;uf;189;27;47;43;58;90;98
catolandia;4;uf;25;4;7;4;9;11;8
catu;3;uf;1964;51;487;178;1140;665;878
catuji;3;uf;1130;85;351;151;509;502;527
caucaia;1;uf;15111;382;3265;2165;8296;5430;6793
caxambu;4;uf;1430;17;371;94;906;465;675
caxias;5;uf;3165;181;704;387;1731;1091;1346
caxias do sul;1;uf;15710;89;2046;484;12754;2530;7555
caxingo;4;uf;65;1;24;7;32;31;28
ceara-mirim;3;uf;1760;75;399;270;897;669;790
cedro de sao joao;4;uf;434;20;107;31;249;138;189
celso ramos;4;uf;5;0;0;2;0;2;3
centralina;3;uf;1126;37;276;119;681;395;591
cerejeiras;4;uf;85;1;35;13;33;48;37
ceres;4;uf;12;1;2;4;5;6;4
cerrito;4;uf;206;6;45;22;131;67;103
cerro azul;4;uf;11;0;3;1;7;4;6
cerro largo;4;uf;167;8;50;32;73;82;79
ceu azul;3;uf;3521;105;747;342;2211;1089;1381
cezarina;4;uf;968;18;295;114;517;409;457
cha grande;4;uf;1;0;0;0;1;0;1
chapadao do sul;4;uf;285;18;92;63;103;155;126
chapadinha;4;uf;73;14;14;11;28;25;31
chapeco;3;uf;3731;59;816;245;2531;1061;1696
chiador;4;uf;8;0;2;0;6;2;4
chopinzinho;4;uf;639;33;142;42;388;184;261
chorozinho;3;uf;2897;69;480;285;1922;765;1100
chorrocho;4;uf;471;56;116;82;195;198;183
chui;4;uf;134;4;36;4;87;40;64
chupinguaia;4;uf;15;1;5;0;9;5;7
cianorte;4;uf;32;1;12;6;12;18;15
cicero dantas;4;uf;614;48;160;82;264;242;239
cidade ocidental;4;uf;51;1;13;2;29;15;26
cidelandia;4;uf;241;14;63;22;126;85;109
cipo;4;uf;226;15;74;28;94;102;87
ciriaco;4;uf;279;18;53;36;167;89;127
claro dos pocoes;4;uf;594;29;231;116;213;347;248
claudia;4;uf;252;7;51;14;170;65;102
cocal;4;uf;108;6;30;14;54;44;56
cocal de telha;4;uf;284;29;44;38;156;82;158
cocalzinho de goias;3;uf;1883;126;593;324;730;917;769
codo;3;uf;869;65;229;86;460;315;363
colatina;5;uf;3102;115;815;596;1447;1411;1447
colinas;4;uf;33;3;7;4;17;11;18
colinas;4;uf;33;3;7;4;17;11;18
colinas do tocantins;3;uf;1442;91;340;181;766;521;612
colombo;5;uf;7470;131;1841;761;4240;2602;3336
colonia do gurgueia;4;uf;60;5;13;1;37;14;31
colonia leopoldina;4;uf;134;22;23;38;48;61;52
colorado;4;uf;47;0;13;2;32;15;21
colorado do oeste;4;uf;206;4;89;23;84;112;96
comendador gomes;3;uf;1190;47;243;79;797;322;479
comendador levy gasparian;4;uf;1258;18;238;41;940;279;727
comodoro;3;uf;1463;71;348;127;883;475;634
conceicao da barra;3;uf;1893;88;546;243;922;789;793
conceicao da feira;4;uf;600;20;151;34;370;185;252
conceicao das alagoas;4;uf;49;1;16;8;23;24;27
conceicao de macabu;4;uf;256;15;53;24;149;77;115
conceicao do almeida;3;uf;1190;59;324;124;637;448;536
conceicao do castelo;4;uf;979;23;274;167;484;441;446
conceicao do coite;4;uf;2;0;0;0;2;0;1
conceicao do jacuipe;3;uf;1760;64;407;142;1057;549;808
conceicao do para;4;uf;88;3;16;12;54;28;43
conceicao do rio verde;4;uf;790;19;236;74;446;310;378
concordia;3;uf;1632;42;442;188;937;630;814
condado;4;uf;247;14;56;36;127;92;123
conde;4;uf;838;22;208;89;476;297;455
condor;4;uf;363;6;88;18;242;106;148
congonhal;4;uf;745;29;224;118;355;342;329
congonhas;5;uf;6043;164;1467;487;3754;1954;2485
conquista doeste;4;uf;466;26;144;49;236;193;181
conselheiro lafaiete;5;uf;5690;150;1525;535;3304;2060;2552
conselheiro mairinck;4;uf;266;17;95;29;113;124;121
constantina;4;uf;19;0;7;1;10;8;12
contagem;1;uf;21267;170;3362;1313;15747;4675;9672
contenda;4;uf;843;33;239;101;423;340;420
coqueiro seco;4;uf;1;0;0;0;1;0;1
coracao de jesus;4;uf;8;0;2;1;5;3;6
coracao de maria;4;uf;66;9;20;5;30;25;30
corbelia;3;uf;1611;48;398;124;996;522;690
cordilheira alta;4;uf;1244;32;323;92;771;415;552
coreau;4;uf;238;23;40;30;133;70;82
corguinho;4;uf;3;0;1;2;0;3;2
corinto;3;uf;2079;120;599;296;993;895;886
cornelio procopio;3;uf;1629;32;505;150;887;655;793
coromandel;4;uf;7;0;0;0;7;0;1
coronel barros;4;uf;636;12;101;35;481;136;289
coronel bicaco;4;uf;312;13;104;34;156;138;133
coronel fabriciano;4;uf;508;29;168;59;244;227;222
coronel joao sa;4;uf;12;2;4;1;4;5;7
coronel jose dias;4;uf;1;1;0;0;0;0;1
coronel vivida;4;uf;1022;15;264;83;623;347;448
corrego danta;3;uf;2134;76;597;235;1202;832;1092
correia pinto;3;uf;1786;56;424;187;1050;611;905
corrente;4;uf;130;24;56;21;26;77;37
correntes;4;uf;78;12;15;12;27;27;38
correntina;3;uf;752;80;197;72;371;269;169
corumba;3;uf;1418;42;356;138;842;494;664
corumba de goias;4;uf;371;13;116;84;145;200;173
corupa;3;uf;1550;35;531;207;733;738;764
costa rica;4;uf;159;17;38;30;73;68;74
cotegipe;4;uf;4;0;0;0;4;0;2
cotia;4;uf;2;0;1;0;1;1;1
coxim;3;uf;2171;55;545;227;1277;772;898
criciuma;4;uf;693;17;207;28;419;235;385
crisolita;4;uf;1;0;0;0;1;0;1
crisopolis;4;uf;12;2;3;3;3;6;5
cristal;4;uf;1092;34;217;108;711;325;518
cristalandia do piaui;4;uf;60;11;27;4;17;31;21
cristalina;5;uf;4845;250;1306;643;2407;1949;2095
cristiano otoni;3;uf;1488;46;438;121;825;559;739
cristinapolis;4;uf;787;35;151;101;443;252;369
cristino castro;4;uf;265;21;81;24;127;105;89
cristopolis;3;uf;977;65;289;71;492;360;334
crixas do tocantins;4;uf;310;16;79;50;158;129;115
croata;4;uf;137;7;33;13;76;46;61
cruz alta;3;uf;2703;52;508;144;1962;652;1150
cruz das almas;3;uf;1168;57;259;94;694;353;502
cruz do espirito santo;4;uf;699;35;200;82;339;282;346
cruzeiro;4;uf;1011;13;151;43;765;194;530
cruzeiro do oeste;4;uf;22;3;6;9;4;15;9
cruzeiro do sul;4;uf;5;0;0;4;1;4;2
cruzilia;4;uf;10;0;5;0;5;5;3
cuiaba;5;uf;4957;109;880;475;3407;1355;2375
cuite;4;uf;198;42;61;36;51;97;84
cujubim;4;uf;87;1;20;4;56;24;30
cumari;4;uf;718;18;107;57;524;164;294
cunha;4;uf;2;0;1;1;0;2;2
cunha pora;4;uf;1071;32;276;139;587;415;528
cupira;4;uf;296;39;67;34;124;101;131
curitiba;2;uf;53273;581;10382;2872;36629;13254;23714
curitibanos;3;uf;1784;62;564;166;946;730;860
currais novos;3;uf;1135;44;309;190;531;499;537
curral de dentro;4;uf;186;9;54;26;91;80;100
curvelo;5;uf;6047;269;1584;827;3184;2411;2662
custodia;3;uf;765;59;147;163;355;310;322
darcinopolis;4;uf;634;33;124;54;393;178;259
dario meira;4;uf;1;0;0;0;1;0;1
davinopolis;4;uf;34;3;16;5;8;21;10
delfim moreira;4;uf;33;0;12;6;15;18;18
delmiro gouveia;4;uf;728;29;192;110;330;302;264
delta;4;uf;822;13;225;46;511;271;431
demerval lobao;4;uf;748;43;187;99;369;286;369
deodapolis;4;uf;3;0;1;1;1;2;1
descanso;3;uf;773;68;204;129;354;333;295
diamante do sul;4;uf;6;0;2;0;4;2;3
diamantino;3;uf;3396;135;774;262;2155;1036;1719
dilermando de aguiar;4;uf;225;4;60;15;143;75;114
dionisio cerqueira;4;uf;338;8;66;42;211;108;168
divino;4;uf;497;39;137;70;226;207;243
divinopolis;4;uf;3;0;0;0;3;0;2
divisa alegre;4;uf;499;36;114;45;276;159;230
dois irmaos;3;uf;2132;25;575;167;1276;742;1041
dois irmaos do buriti;4;uf;741;20;137;120;448;257;297
dois irmaos do tocantins;4;uf;2;0;1;0;1;1;1
dois lajeados;4;uf;1;0;0;0;1;0;1
dois riachos;4;uf;258;21;56;56;105;112;98
dom aquino;4;uf;447;22;124;41;253;165;216
dom cavati;4;uf;526;28;158;95;230;253;213
dom eliseu;3;uf;1924;96;460;270;965;730;828
dom expedito lopes;4;uf;683;46;138;100;354;238;319
dom macedo costa;4;uf;19;1;2;1;14;3;11
dom pedrito;4;uf;798;17;163;41;568;204;390
dom pedro;4;uf;69;9;16;5;35;21;31
dom pedro de alcantara;4;uf;546;11;90;29;401;119;267
domingos martins;5;uf;4861;83;1295;604;2698;1899;2373
dores do rio preto;4;uf;3;1;1;0;1;1;2
douradina;4;uf;621;24;140;69;345;209;243
dourados;5;uf;6132;98;1591;654;3604;2245;2646
duere;4;uf;70;5;11;10;41;21;31
duque de caxias;2;uf;37859;407;6388;1273;28066;7661;17531
eldorado;4;uf;985;32;228;87;594;315;465
eldorado do carajas;4;uf;89;8;16;12;46;28;34
eldorado do sul;5;uf;6170;98;988;444;4492;1432;2627
eldorado dos carajas;4;uf;232;10;65;23;103;88;73
elesbao veloso;4;uf;579;45;134;99;264;233;256
eliseu martins;4;uf;15;6;3;1;5;4;7
emas;4;uf;2;0;0;0;2;0;1
embu;5;uf;5795;118;968;430;3889;1398;2638
embu das artes;4;uf;900;13;317;56;459;373;393
encruzilhada;4;uf;1180;41;206;59;830;265;497
encruzilhada do sul;4;uf;30;0;4;1;25;5;12
engenheiro caldas;3;uf;1099;71;357;178;467;535;523
engenheiro navarro;4;uf;721;44;274;103;261;377;283
entre ijuis;4;uf;947;28;245;64;606;309;433
entre rios;3;uf;1219;68;353;127;614;480;535
entre-ijuis;4;uf;104;4;35;9;53;44;46
epitaciolandia;4;uf;254;11;85;26;119;111;89
erebango;4;uf;4;0;1;0;3;1;2
erechim;3;uf;4620;50;916;291;3182;1207;2124
ermo;4;uf;2;0;1;0;1;1;1
erval velho;4;uf;958;26;259;59;601;318;453
escada;3;uf;1368;68;256;117;803;373;688
esmeraldas;3;uf;3313;79;891;284;1918;1175;1590
esperanca;4;uf;416;21;80;73;221;153;203
esplanada;3;uf;845;62;242;104;399;346;375
estancia;3;uf;3110;93;625;258;1940;883;1394
estancia velha;4;uf;1942;16;330;66;1490;396;884
esteio;3;uf;4811;42;699;146;3833;845;2300
estiva;3;uf;3126;44;910;195;1904;1105;1824
estreito;4;uf;759;47;200;98;359;298;334
estrela;3;uf;2457;49;553;165;1609;718;1176
estrela de alagoas;4;uf;256;19;82;46;86;128;112
estrela do norte;4;uf;718;50;155;130;357;285;238
estrela do sul;4;uf;60;15;9;13;23;22;21
euclides da cunha;4;uf;509;46;136;50;253;186;219
eugenopolis;4;uf;595;16;249;67;248;316;323
eunapolis;5;uf;8029;151;1722;622;5204;2344;3310
eusebio;3;uf;1866;28;365;171;1179;536;879
ewbank da camara;4;uf;914;22;260;51;571;311;458
extrema;3;uf;3813;76;920;251;2413;1171;2148
extremoz;4;uf;923;26;212;149;485;361;404
farias brito;4;uf;32;9;3;7;11;10;10
farol;4;uf;283;19;84;42;127;126;126
fatima;4;uf;278;17;64;39;145;103;111
faxinal dos guedes;3;uf;1212;55;333;139;652;472;532
fazenda rio grande;5;uf;4849;76;1089;363;3069;1452;2097
fazenda vilanova;3;uf;1282;42;283;89;845;372;568
feira de santana;2;uf;27427;466;5075;1946;18166;7021;12533
felipe guerra;4;uf;158;15;41;23;68;64;75
felixlandia;3;uf;1293;93;401;236;530;637;567
fernandes pinheiro;4;uf;522;15;146;70;277;216;221
fernando pedroza;4;uf;180;16;47;16;92;63;94
ferreira gomes;4;uf;271;11;75;42;118;117;89
fervedouro;4;uf;767;38;220;108;375;328;357
figueirao;4;uf;2;0;1;0;1;1;1
figueiropolis;4;uf;601;15;122;54;398;176;243
figueiropolis doeste;4;uf;82;0;18;1;58;19;24
filadelfia;4;uf;381;21;99;29;203;128;143
flexeiras;3;uf;984;50;207;158;513;365;544
flor da serra do sul;4;uf;672;27;187;84;347;271;252
flor do sertao;4;uf;2;0;0;0;2;0;1
florania;4;uf;94;10;28;20;32;48;39
flores;4;uf;487;34;131;63;238;194;196
flores da cunha;4;uf;1;0;0;0;1;0;1
flores de goias;3;uf;827;61;229;104;403;333;303
floresta;4;uf;722;32;220;86;365;306;333
floresta do araguaia;4;uf;3;0;1;1;1;2;1
florestal;4;uf;445;12;136;62;220;198;235
floriano;5;uf;3240;87;820;587;1475;1407;1579
florianopolis;5;uf;10081;59;1900;418;7302;2318;4394
fontoura xavier;4;uf;1297;28;280;99;857;379;557
formigueiro;4;uf;8;0;3;0;5;3;3
formosa;5;uf;4808;231;1301;435;2639;1736;1775
formosa do rio preto;4;uf;339;41;89;27;170;116;151
formoso do araguaia;4;uf;308;17;110;62;113;172;130
forquetinha;4;uf;56;2;11;2;40;13;23
forquilha;4;uf;822;27;204;125;427;329;341
fortaleza;1;uf;23216;334;3509;1863;16017;5372;10489
fortaleza do tabocao;4;uf;820;43;185;72;502;257;351
fortaleza dos nogueiras;4;uf;2;0;0;2;0;2;1
foz do iguacu;1;uf;12582;142;3169;1001;7707;4170;5560
foz do jordao;4;uf;26;1;4;4;17;8;9
fraiburgo;4;uf;1;0;0;0;1;0;1
francisco alves;4;uf;321;10;62;28;201;90;125
francisco beltrao;4;uf;2;0;1;0;1;1;1
francisco macedo;4;uf;156;21;19;27;78;46;80
francisco sa;5;uf;3376;151;1004;317;1835;1321;1509
francisco santos;4;uf;171;28;33;23;80;56;74
frecheirinha;4;uf;206;25;35;30;95;65;104
frederico westphalen;3;uf;2564;56;677;169;1584;846;1166
frei inocencio;4;uf;544;27;136;68;296;204;251
frei paulo;4;uf;343;30;114;64;99;178;152
frei rogerio;4;uf;2;0;0;0;2;0;1
fronteira;3;uf;1508;56;471;150;776;621;604
fronteiras;4;uf;35;5;5;7;18;12;17
fruta de leite;4;uf;503;17;141;46;284;187;249
frutal;5;uf;3753;135;934;293;2313;1227;1809
fundao;3;uf;2789;78;460;291;1806;751;1222
gameleira;4;uf;322;26;64;41;161;105;167
gandu;3;uf;1178;43;267;131;679;398;561
garanhuns;5;uf;3784;188;917;526;1852;1443;1655
garibaldi;4;uf;599;11;163;41;357;204;229
garopaba;4;uf;589;15;186;64;314;250;289
garuva;3;uf;4189;64;850;152;2988;1002;2185
gaspar;5;uf;4688;89;1278;410;2757;1688;1987
gaurama;4;uf;5;0;3;0;2;3;2
gaviao;4;uf;275;26;69;32;140;101;105
geminiano;4;uf;261;29;73;42;101;115;130
general carneiro;5;uf;4038;147;1062;344;2391;1406;1852
general carneiro;5;uf;4038;147;1062;344;2391;1406;1852
gentil;4;uf;88;2;27;5;46;32;39
getulina;4;uf;521;13;148;44;302;192;240
gilbues;4;uf;59;13;15;7;20;22;18
gloria de dourados;4;uf;4;0;1;2;1;3;1
gloria doeste;4;uf;207;9;49;20;123;69;97
glorinha;3;uf;2012;30;533;97;1311;630;1116
goiana;3;uf;3090;77;549;227;2047;776;1532
goianapolis;3;uf;3294;30;800;278;2079;1078;1654
goianesia;4;uf;1;0;0;0;1;0;1
goiania;1;uf;17413;188;2821;1457;12158;4278;7798
goianinha;4;uf;1088;30;246;107;624;353;527
goias;4;uf;18;1;7;1;7;8;8
goiatuba;3;uf;1631;55;393;175;970;568;853
goio-ere;4;uf;239;26;63;45;96;108;114
goioere;4;uf;40;1;14;13;10;27;18
gongogi;4;uf;3;0;2;0;1;2;1
governador celso ramos;4;uf;99;2;30;9;51;39;49
governador dix-sept rosado;4;uf;135;5;41;24;48;65;62
governador edison lobao;3;uf;692;62;161;86;342;247;264
governador eugenio barros;4;uf;13;1;5;2;5;7;4
governador mangabeira;3;uf;1001;59;231;110;535;341;426
governador newton bello;4;uf;97;12;15;19;46;34;47
governador nunes freire;4;uf;69;8;8;14;32;22;29
governador valadares;1;uf;9521;200;2852;987;5266;3839;4380
grajau;4;uf;334;32;129;46;112;175;108
grao mogol;5;uf;2983;183;901;324;1481;1225;1399
gravata;5;uf;4443;103;962;457;2699;1419;2109
gravatai;3;uf;3813;70;742;142;2777;884;2009
guacui;4;uf;32;0;17;5;10;22;16
guadalupe;4;uf;34;2;5;12;10;17;12
guaiba;3;uf;3628;63;612;224;2624;836;1508
guaicara;4;uf;584;18;181;40;333;221;256
guaimbe;4;uf;297;10;88;26;167;114;134
guaira;3;uf;3441;29;321;100;2922;421;1185
guairaca;4;uf;415;19;118;39;219;157;167
guajara-mirim;4;uf;19;2;7;1;7;8;9
guamare;4;uf;182;25;42;40;64;82;82
guamiranga;4;uf;536;32;140;97;246;237;252
guapimirim;5;uf;5601;115;1200;393;3656;1593;2609
guapirama;4;uf;152;9;41;12;85;53;72
guapo;3;uf;1893;50;493;252;1042;745;975
guaraciaba;3;uf;1265;42;260;95;829;355;575
guarai;3;uf;1794;46;441;189;1055;630;782
guaramirim;5;uf;7862;59;2081;676;4900;2757;3536
guarani das missoes;4;uf;247;17;88;37;101;125;93
guarani de goias;4;uf;327;37;97;34;152;131;115
guaraniacu;3;uf;1990;77;524;206;1118;730;924
guaranta do norte;4;uf;544;39;158;93;227;251;268
guaranta do norte;4;uf;544;39;158;93;227;251;268
guarapari;5;uf;4584;192;1147;392;2685;1539;2064
guarapuava;5;uf;6276;211;1717;576;3576;2293;2789
guarara;4;uf;235;6;80;33;111;113;115
guararema;3;uf;1730;40;268;56;1280;324;896
guaratingueta;3;uf;3870;70;866;176;2576;1042;1901
guaratuba;1;uf;12525;151;2045;480;9588;2525;6962
guaruja do sul;4;uf;387;16;87;52;223;139;184
guarulhos;2;uf;40350;430;8282;1040;27409;9322;18109
guaxupe;4;uf;33;1;15;6;8;21;17
guia lopes da laguna;4;uf;598;18;134;64;366;198;261
guimarania;4;uf;351;13;92;25;205;117;168
gurinhata;4;uf;111;9;46;13;39;59;49
gurinhem;4;uf;995;26;265;129;540;394;520
gurjao;4;uf;1;0;0;0;1;0;1
gurupi;3;uf;2039;85;516;190;1190;706;923
herval doeste;4;uf;469;26;122;49;259;171;228
hidrolandia;3;uf;2604;50;602;259;1610;861;1312
hidrolina;4;uf;409;13;91;46;241;137;168
horizonte;3;uf;1818;80;401;276;896;677;798
hulha negra;4;uf;428;7;94;34;283;128;202
humaita;4;uf;376;19;129;48;159;177;149
humaita;4;uf;376;19;129;48;159;177;149
humberto de campos;4;uf;52;8;16;10;10;26;19
iati;4;uf;175;19;40;17;83;57;61
ibaiti;4;uf;790;28;213;84;438;297;345
ibaretama;4;uf;1;0;0;1;0;1;1
ibateguara;4;uf;103;19;16;34;27;50;46
ibatiba;3;uf;2834;86;762;461;1383;1223;1371
ibema;4;uf;602;39;146;72;322;218;258
ibia;3;uf;2293;74;644;192;1337;836;1082
ibiai;4;uf;2;0;1;0;1;1;2
ibicarai;4;uf;2;0;1;0;1;1;2
ibimirim;4;uf;225;25;47;53;76;100;112
ibipora;3;uf;2076;19;616;254;1100;870;931
ibiquera;4;uf;310;13;96;31;153;127;137
ibiracu;3;uf;3436;106;648;438;2095;1086;1540
ibirama;3;uf;3711;79;956;253;2337;1209;1704
ibirapitanga;3;uf;1591;119;438;190;761;628;763
ibirapua;4;uf;258;14;53;19;157;72;103
ibirapuita;4;uf;16;0;5;5;4;10;5
ibirataia;4;uf;16;0;7;0;8;7;5
ibiruba;4;uf;48;0;13;4;29;17;24
ibitiara;4;uf;757;30;197;54;452;251;296
ibotirama;4;uf;438;18;96;28;276;124;178
icapui;4;uf;21;0;7;1;13;8;10
icara;3;uf;2689;72;940;204;1392;1144;1457
icaraima;4;uf;26;1;6;0;19;6;9
icatu;4;uf;2;0;0;0;2;0;1
icem;4;uf;798;33;191;71;475;262;353
ico;3;uf;1160;57;226;187;645;413;515
iconha;3;uf;2375;42;499;181;1574;680;1090
ielmo marinho;4;uf;42;5;6;3;26;9;24
igaci;4;uf;31;2;11;2;14;13;11
igarape;3;uf;3371;41;776;177;2300;953;1746
igarape do meio;4;uf;422;21;84;62;241;146;211
igarape-acu;4;uf;60;4;9;14;28;23;23
igarassu;5;uf;7613;150;1213;519;5287;1732;3452
igaratinga;3;uf;1108;36;316;112;614;428;562
igreja nova;4;uf;21;0;1;1;19;2;10
iguaracu;4;uf;2;0;0;0;2;0;1
iguatemi;4;uf;1;0;0;0;1;0;1
ijui;3;uf;2296;36;521;136;1562;657;975
ilheus;4;uf;694;13;216;62;371;278;302
ilhota;3;uf;1579;42;413;148;911;561;645
imarui;4;uf;5;0;4;0;1;4;1
imbau;4;uf;986;40;220;99;588;319;460
imbe de minas;4;uf;4;0;0;2;2;2;1
imbituba;5;uf;4804;104;1373;470;2698;1843;2501
imbituva;3;uf;1157;64;348;139;554;487;568
imperatriz;1;uf;9739;183;2135;1003;5863;3138;4008
indaial;1;uf;10161;119;2753;864;6034;3617;4478
indaiatuba;4;uf;2;0;0;0;2;0;1
independencia;4;uf;40;3;31;5;1;36;4
indianopolis;4;uf;987;36;271;137;519;408;395
indiara;3;uf;1592;63;422;205;841;627;797
inga;4;uf;815;27;261;90;409;351;432
inhambupe;4;uf;501;57;177;73;164;250;228
inhapi;4;uf;421;27;103;88;181;191;147
inhapim;3;uf;1670;81;481;241;824;722;773
inhuma;4;uf;293;28;62;38;148;100;126
ipameri;4;uf;610;11;135;63;381;198;234
ipanema;4;uf;133;3;49;27;53;76;76
ipanguacu;4;uf;65;2;26;8;25;34;28
ipatinga;4;uf;132;0;46;14;71;60;68
ipaumirim;4;uf;470;21;110;32;270;142;205
ipiau;4;uf;356;22;121;39;161;160;163
ipigua;4;uf;1;0;1;0;0;1;1
ipiranga;4;uf;360;16;90;51;195;141;173
ipiranga do piaui;4;uf;245;12;92;38;95;130;104
ipiranga do sul;4;uf;5;0;3;0;2;3;3
ipixuna do para;4;uf;809;52;204;95;416;299;353
ipojuca;4;uf;514;19;147;33;279;180;264
ipubi;4;uf;2;1;0;0;0;0;1
ipuiuna;4;uf;285;10;84;44;135;128;148
ipumirim;4;uf;2;0;0;0;2;0;1
iracema;4;uf;165;14;55;26;50;81;41
iraceminha;4;uf;846;26;202;102;493;304;398
irai;4;uf;383;23;121;39;185;160;162
irajuba;3;uf;947;61;214;48;583;262;462
irani;3;uf;2053;40;553;178;1248;731;930
irati;3;uf;2260;63;652;245;1210;897;1037
iraucuba;3;uf;1156;52;269;161;626;430;484
iretama;4;uf;431;18;121;55;221;176;223
irineopolis;4;uf;290;3;106;41;131;147;118
irituia;4;uf;357;40;67;47;180;114;145
irupi;4;uf;22;1;5;5;10;10;12
itaara;4;uf;750;10;190;62;469;252;382
itabaiana;3;uf;3192;98;905;409;1529;1314;1451
itabaiana;3;uf;3192;98;905;409;1529;1314;1451
itabela;3;uf;2493;134;553;244;1472;797;1046
itaberaba;3;uf;1715;58;487;130;982;617;728
itaberai;4;uf;90;11;30;23;26;53;38
itabira;4;uf;28;1;5;2;19;7;14
itabirito;5;uf;4263;130;1014;551;2472;1565;2037
itaborai;1;uf;12546;214;1915;660;9227;2575;5694
itabuna;3;uf;3197;77;778;271;1928;1049;1351
itacare;4;uf;6;1;0;0;3;0;3
itacuruba;4;uf;145;1;43;24;71;67;60
itagi;4;uf;1;0;0;0;0;0;1
itagimirim;4;uf;819;27;202;68;499;270;304
itaguai;5;uf;6917;193;1495;526;4400;2021;3017
itaguara;3;uf;3905;71;905;197;2661;1102;2059
itaguari;4;uf;53;4;17;14;15;31;26
itaiba;4;uf;41;6;8;8;19;16;18
itaiopolis;3;uf;957;51;254;116;501;370;421
itaitinga;3;uf;1550;31;341;174;885;515;751
itaituba;4;uf;504;18;171;58;214;229;191
itaja;4;uf;437;23;117;40;217;157;193
itajai;1;uf;16184;144;3028;679;11697;3707;7147
itajuba;4;uf;264;18;80;56;105;136;104
itajuipe;4;uf;811;26;184;79;506;263;382
italva;4;uf;569;23;204;58;264;262;268
itamaraju;5;uf;3450;124;661;546;1973;1207;1390
itambacuri;3;uf;1372;79;409;131;714;540;555
itamonte;4;uf;1333;21;409;106;738;515;677
itanhandu;4;uf;192;11;71;18;87;89;105
itanhem;4;uf;3;0;0;0;3;0;1
itaobim;3;uf;1823;65;521;236;943;757;896
itapaci;4;uf;13;0;6;1;6;7;5
itapage;3;uf;1055;59;233;182;489;415;481
itapaje;4;uf;266;20;60;43;125;103;101
itape;4;uf;29;0;7;4;16;11;15
itapebi;3;uf;1722;90;405;118;1055;523;806
itapecerica da serra;5;uf;4734;90;804;368;3211;1172;2283
itapecuru mirim;3;uf;2448;120;303;261;1620;564;1139
itapema;5;uf;6293;80;1567;286;4128;1853;2844
itapemirim;3;uf;1384;38;310;114;864;424;775
itaperuna;3;uf;2753;113;934;213;1441;1147;1246
itapeva;3;uf;2109;20;530;136;1354;666;1305
itapipoca;4;uf;89;15;10;14;39;24;41
itapirapua;4;uf;110;6;39;21;44;60;40
itapissuma;4;uf;182;6;39;14;108;53;103
itapora;4;uf;2;0;0;2;0;2;1
itaporanga;4;uf;125;19;37;22;42;59;58
itaporanga dajuda;3;uf;1828;49;319;103;1256;422;809
itapua do oeste;4;uf;313;10;82;8;188;90;113
itapuã do oeste;4;uf;1107;36;227;101;683;328;373
itaquaquecetuba;4;uf;2;0;0;0;2;0;1
itaquara;4;uf;56;4;18;11;21;29;22
itaqui;4;uf;681;12;179;43;436;222;322
itaquirai;4;uf;1301;31;349;91;787;440;635
itaquitinga;4;uf;4;0;2;1;1;3;2
itatiaia;3;uf;4010;56;549;155;3083;704;2148
itatiaiucu;3;uf;4121;53;1039;172;2782;1211;2368
itatim;3;uf;955;66;180;65;609;245;384
itatira;4;uf;87;8;12;17;42;29;39
itau;4;uf;136;16;39;14;52;53;60
itauba;4;uf;795;20;157;86;500;243;334
itauna;4;uf;3;0;1;0;2;1;2
itinga do maranhao;4;uf;232;25;49;34;113;83;100
itiquira;3;uf;1455;54;308;156;926;464;637
ituiutaba;4;uf;548;23;143;77;285;220;264
itumbiara;3;uf;2798;73;623;293;1741;916;1438
itupiranga;4;uf;155;13;32;20;53;52;50
ituporanga;4;uf;2;0;0;0;2;0;2
iuna;4;uf;497;35;113;83;236;196;222
ivai;4;uf;14;1;6;1;6;7;6
ivoti;4;uf;671;5;118;24;510;142;305
jaboatao dos guararapes;1;uf;12379;193;1884;707;8812;2591;5660
jabora;4;uf;2;0;0;0;2;0;2
jaboticaba;4;uf;1;0;1;0;0;1;1
jacarau;4;uf;4;0;3;0;1;3;1
jacareacanga;4;uf;4;0;0;0;4;0;2
jacarei;5;uf;6756;71;891;181;5271;1072;3228
jacarezinho;3;uf;1605;32;414;138;970;552;781
jaci;4;uf;503;14;110;33;328;143;256
jaciara;5;uf;4239;127;743;332;2951;1075;2005
jacobina;4;uf;13;3;3;3;3;6;6
jacobina do piaui;4;uf;85;11;24;18;25;42;39
jacuipe;4;uf;2;0;0;1;0;1;1
jacupiranga;3;uf;2109;52;516;146;1317;662;1173
jaguaquara;3;uf;2718;125;452;185;1855;637;1023
jaguaracu;4;uf;1145;25;291;80;726;371;515
jaguarao;4;uf;447;18;112;44;261;156;202
jaguarari;3;uf;1255;65;300;108;718;408;456
jaguare;4;uf;863;40;202;103;473;305;388
jaguari;4;uf;652;20;139;50;435;189;292
jaguaribara;4;uf;283;17;50;37;165;87;122
jaguaribe;3;uf;1071;49;261;135;586;396;465
jaguaruana;4;uf;4;0;1;0;3;1;2
jaguaruna;3;uf;1495;39;489;88;840;577;761
jaicos;4;uf;198;28;47;38;76;85;92
jampruca;4;uf;370;22;98;29;211;127;163
jandaia;4;uf;390;9;104;45;220;149;201
jandaia do sul;3;uf;1346;28;434;150;657;584;571
jandaira;4;uf;201;27;46;38;75;84;82
janduis;4;uf;40;5;13;7;14;20;16
jangada;3;uf;2361;94;403;146;1625;549;1130
janiopolis;4;uf;263;13;71;39;129;110;114
japaratuba;4;uf;595;18;161;33;335;194;246
japeri;4;uf;32;1;8;0;22;8;17
japira;4;uf;119;3;39;18;55;57;48
jaragua;3;uf;3134;110;680;427;1860;1107;1208
jaragua do sul;3;uf;3286;58;794;312;2038;1106;1483
jaraguari;3;uf;1896;53;354;147;1306;501;749
jardim;4;uf;1127;25;336;117;617;453;497
jardim do serido;4;uf;336;20;89;74;141;163;184
jaru;5;uf;4826;109;1326;458;2780;1784;2013
jatai;5;uf;6524;133;1636;473;4034;2109;3138
jataizinho;4;uf;769;12;192;90;439;282;354
jati;4;uf;280;24;72;39;132;111;122
jatoba;4;uf;212;20;68;38;77;106;84
jauru;4;uf;73;0;26;5;40;31;29
jenipapo dos vieiras;4;uf;24;4;4;0;10;4;11
jequia da praia;4;uf;471;14;112;61;259;173;240
jequie;5;uf;5422;197;1118;408;3512;1526;2083
jequitai;3;uf;1123;53;407;164;484;571;533
jeremoabo;3;uf;1182;62;281;138;608;419;478
jeronimo monteiro;4;uf;8;0;2;3;3;5;6
jerumenha;4;uf;191;15;48;29;86;77;85
ji-parana;5;uf;8212;93;2180;722;5024;2902;3585
jiquirica;4;uf;25;3;5;7;9;12;11
jitauna;4;uf;354;27;111;53;146;164;147
joacaba;3;uf;2240;46;561;154;1424;715;1015
joao camara;3;uf;683;56;153;124;296;277;323
joao costa;4;uf;13;2;7;3;1;10;2
joao monlevade;5;uf;6570;113;1870;616;3865;2486;3138
joao neiva;3;uf;2923;88;639;361;1692;1000;1370
joao pessoa;1;uf;23328;172;4633;1370;15818;6003;10302
joao pinheiro;5;uf;3742;117;1011;296;2203;1307;1629
joaquim felicio;3;uf;1321;74;431;177;610;608;501
joaquim gomes;3;uf;965;49;189;155;524;344;526
joaquim nabuco;4;uf;158;11;33;11;94;44;85
joca claudino;4;uf;2;2;0;0;0;0;2
joinville;1;uf;14412;140;3125;594;10096;3719;7206
jose bonifacio;3;uf;1410;40;451;86;779;537;688
jose da penha;4;uf;51;6;12;14;16;26;24
juarez tavora;4;uf;34;0;7;5;21;12;17
juatuba;5;uf;4328;120;1146;425;2515;1571;2375
juazeirinho;4;uf;430;28;109;63;190;172;181
juazeiro;3;uf;2881;84;555;245;1831;800;1150
jucati;4;uf;314;17;78;54;136;132;135
jucurutu;4;uf;141;23;28;23;56;51;60
juiz de fora;5;uf;7193;188;2355;680;3795;3035;3764
julio de castilhos;3;uf;1285;46;317;107;788;424;556
junco do maranhao;4;uf;68;12;21;12;20;33;17
junco do serido;4;uf;351;24;81;32;184;113;135
jundia;4;uf;1;0;0;0;1;0;1
junqueiro;3;uf;968;53;220;109;525;329;425
jupi;4;uf;687;49;171;108;307;279;298
juquia;3;uf;2854;58;592;140;1950;732;1637
juquitiba;5;uf;4718;166;868;384;3073;1252;2488
juranda;4;uf;497;17;168;47;248;215;183
juscimeira;3;uf;1796;34;342;133;1255;475;799
jussara;4;uf;688;44;233;77;315;310;294
jussari;4;uf;36;1;13;2;20;15;23
juti;4;uf;777;19;202;61;470;263;369
labrea;4;uf;29;3;0;5;1;5;3
ladario;4;uf;50;0;21;1;27;22;11
lafaiete coutinho;4;uf;5;0;0;1;3;1;3
lages;5;uf;8678;117;1975;500;5823;2475;3956
lago verde;4;uf;8;1;2;0;5;2;6
lagoa do piaui;4;uf;618;29;164;89;306;253;285
lagoa grande;3;uf;959;59;258;91;526;349;396
lagoa grande;3;uf;959;59;258;91;526;349;396
lagoa real;4;uf;1;0;1;0;0;1;1
lagoa seca;4;uf;831;30;192;111;439;303;361
lagoa vermelha;3;uf;1717;37;447;132;1031;579;799
lagoinha do piaui;4;uf;304;26;74;59;118;133;117
laguna;5;uf;6395;89;1485;414;4244;1899;2971
laje;4;uf;758;44;214;96;362;310;316
laje do muriae;4;uf;1;0;1;0;0;1;1
lajeado;3;uf;3720;57;804;271;2475;1075;1704
lajeado do bugre;4;uf;110;5;31;11;59;42;57
lajeado novo;4;uf;454;60;98;57;208;155;178
lajedinho;4;uf;223;23;75;23;95;98;72
lajedo;3;uf;850;57;158;132;427;290;353
lajes;4;uf;531;25;102;60;323;162;285
lajes pintadas;4;uf;76;2;33;12;26;45;38
lamarao;4;uf;77;4;12;2;56;14;35
lapa;3;uf;2918;104;746;308;1658;1054;1559
laranjal;4;uf;694;39;199;60;368;259;325
laranjal do jari;4;uf;57;3;12;11;25;23;20
laranjeiras;4;uf;1497;36;245;75;1059;320;680
laranjeiras do sul;3;uf;1981;71;572;166;1108;738;952
laurentino;4;uf;16;0;4;0;12;4;10
lauro de freitas;4;uf;1;0;0;0;1;0;1
lavras;3;uf;3742;35;959;123;2556;1082;2421
lavras da mangabeira;4;uf;106;11;27;14;44;41;40
lavrinhas;4;uf;1794;20;311;68;1344;379;1007
lencois;3;uf;1377;63;395;107;740;502;614
lencois paulista;4;uf;1;0;1;0;0;1;1
leopoldina;5;uf;5537;162;1726;507;3005;2233;2666
liberdade;4;uf;200;11;84;25;75;109;106
lima duarte;4;uf;756;40;261;117;307;378;372
limoeiro do norte;4;uf;313;23;73;43;154;116;143
lindoeste;4;uf;1008;17;210;62;690;272;454
linhares;1;uf;15834;198;3600;1319;10101;4919;7189
lins;4;uf;761;10;199;29;502;228;367
loanda;4;uf;44;2;17;2;23;19;20
londrina;5;uf;10487;75;1652;637;7648;2289;4071
lontras;3;uf;2020;39;551;143;1231;694;892
lorena;3;uf;3324;70;957;242;1863;1199;1623
loreto;4;uf;47;3;13;8;19;21;24
lucas do rio verde;3;uf;2311;63;442;148;1565;590;951
lucena;4;uf;1;0;0;0;1;0;1
luis correia;4;uf;341;23;88;47;163;135;167
luis eduardo magalhaes;3;uf;1615;135;486;128;821;614;560
luis gomes;4;uf;20;4;1;2;9;3;6
luislandia;4;uf;3;0;1;0;2;1;2
luiz alves;4;uf;12;0;1;0;11;1;6
luiziana;4;uf;218;9;44;43;115;87;104
lupercio;4;uf;5;0;4;0;1;4;1
luz;5;uf;3039;171;940;435;1450;1375;1400
luziania;5;uf;7854;294;2037;814;4200;2851;3342
luzinopolis;4;uf;50;4;22;3;15;25;21
macae;3;uf;3064;147;644;302;1849;946;1364
macaiba;5;uf;4956;111;882;515;3200;1397;2211
macambara;4;uf;5;1;2;0;2;2;4
macapa;5;uf;4353;55;1218;477;2404;1695;1632
macau;4;uf;159;18;54;20;60;74;64
maceio;1;uf;13172;105;2049;1447;8807;3496;5597
machado;4;uf;347;14;107;34;179;141;167
macurure;4;uf;134;11;28;12;65;40;54
madalena;4;uf;326;22;89;43;151;132;133
mae do rio;4;uf;601;52;122;63;311;185;265
mafra;5;uf;6098;113;1641;545;3628;2186;2782
mage;5;uf;8149;128;1762;409;5464;2171;3970
mairipora;5;uf;8830;134;1557;326;6429;1883;4425
major sales;4;uf;45;9;13;6;14;19;18
malhada dos bois;4;uf;271;1;37;14;211;51;128
mallet;4;uf;258;12;70;47;120;117;142
malta;4;uf;241;20;76;34;90;110;108
mamanguape;3;uf;2458;94;609;284;1354;893;1295
mambore;4;uf;711;29;255;57;350;312;248
manaus;3;uf;4031;79;832;272;2619;1104;1270
mandaguacu;3;uf;1482;27;443;114;845;557;669
mandaguari;3;uf;2254;20;611;163;1342;774;1067
mandirituba;5;uf;3341;132;801;331;1924;1132;1481
mangaratiba;5;uf;5671;154;1691;537;3178;2228;2309
mangueirinha;4;uf;1;0;0;1;0;1;1
manhuacu;1;uf;9477;234;2775;855;5293;3630;4538
manhumirim;4;uf;10;1;2;0;6;2;6
manicore;4;uf;24;3;0;3;18;3;11
manoel emidio;4;uf;30;2;4;2;19;6;15
manoel urbano;4;uf;47;3;15;9;20;24;14
manoel vitorino;4;uf;1016;45;229;72;621;301;455
mansidao;4;uf;7;2;2;1;2;3;2
maquine;4;uf;907;31;225;90;544;315;469
mara rosa;4;uf;602;49;141;86;313;227;226
maraba;1;uf;10980;284;2164;735;7132;2899;4649
maracacume;4;uf;62;8;13;5;32;18;29
maracaja;3;uf;1593;26;471;67;985;538;832
maracaju;3;uf;1009;38;311;129;507;440;454
maracanau;5;uf;4356;112;709;516;2744;1225;1934
maracas;4;uf;22;1;3;0;16;3;14
maranguape;4;uf;670;20;161;51;377;212;285
maranhaozinho;4;uf;43;6;5;4;25;9;19
marau;4;uf;412;43;83;25;238;108;202
maravilha;3;uf;1420;36;357;184;790;541;625
maravilha;3;uf;1420;36;357;184;790;541;625
marcelandia;4;uf;1;0;1;0;0;1;1
marcelino ramos;4;uf;251;7;57;16;160;73;116
marcelino vieira;4;uf;3;0;1;1;0;2;1
marcolandia;4;uf;298;32;56;55;141;111;176
marechal candido rondon;3;uf;1437;29;331;127;896;458;612
marechal deodoro;4;uf;210;6;73;23;97;96;100
marechal floriano;3;uf;3534;60;847;482;2038;1329;1713
marialva;3;uf;1805;46;504;159;1043;663;830
mariana pimentel;4;uf;26;0;3;3;20;6;8
maribondo;4;uf;417;25;94;51;211;145;169
marilandia;4;uf;1;0;0;0;1;0;1
marilandia do sul;4;uf;636;24;184;50;352;234;254
marilia;3;uf;1894;22;487;69;1247;556;994
maringa;1;uf;16125;114;3925;994;10362;4919;7256
mario campos;4;uf;2;0;0;0;2;0;1
maripa de minas;4;uf;349;10;114;34;176;148;169
marituba;5;uf;7679;100;1166;491;5527;1657;3282
marizopolis;4;uf;287;18;83;61;103;144;141
marmeleiro;4;uf;389;8;109;30;231;139;180
marques de souza;3;uf;1900;36;430;121;1275;551;844
marquinho;4;uf;86;5;38;8;34;46;47
martins;4;uf;1;0;1;0;0;1;1
martins soares;3;uf;981;39;316;135;461;451;457
maruim;3;uf;1925;63;312;103;1351;415;821
marumbi;4;uf;1;0;1;0;0;1;1
mascote;3;uf;1403;72;306;164;802;470;685
massaranduba;4;uf;230;8;71;18;126;89;137
mata;4;uf;28;1;8;4;14;12;18
mata grande;4;uf;10;2;3;1;1;4;6
mataraca;4;uf;185;5;46;15;107;61;114
matelandia;3;uf;3738;74;854;295;2344;1149;1551
mateus leme;4;uf;605;20;192;73;306;265;368
mathias lobato;4;uf;494;27;134;62;262;196;232
matias barbosa;4;uf;1305;21;377;89;774;466;726
matinha;4;uf;2;0;0;0;2;0;1
matinhos;4;uf;2;0;0;0;1;0;1
matipo;3;uf;1071;50;326;123;545;449;473
mato castelhano;4;uf;530;16;121;48;326;169;233
matoes;4;uf;17;3;2;3;8;5;7
matoes do norte;4;uf;369;26;83;40;197;123;195
matozinhos;4;uf;4;0;3;0;1;3;1
matriz de camaragibe;4;uf;3;0;0;0;2;0;2
matupa;4;uf;661;41;198;132;250;330;265
matupa;4;uf;661;41;198;132;250;330;265
maua;4;uf;1;0;1;0;0;1;1
maua da serra;3;uf;1548;31;428;140;905;568;857
maurilandia;4;uf;348;18;89;35;191;124;162
maxaranguape;4;uf;144;5;42;47;46;89;58
mazagao;4;uf;246;4;90;23;114;113;64
medianeira;3;uf;3959;77;1021;325;2361;1346;1724
medicilandia;4;uf;157;21;44;16;61;60;62
medina;3;uf;1240;95;385;143;583;528;612
mercedes;4;uf;471;11;106;34;297;140;204
mesquita;4;uf;1717;32;187;49;1346;236;720
messias;3;uf;1146;63;227;210;566;437;507
messias targino;4;uf;24;6;8;1;8;9;13
miguel alves;4;uf;2;1;0;0;0;0;1
miguel leao;4;uf;69;5;24;15;20;39;24
milagres;3;uf;2024;68;442;187;1230;629;799
milagres;3;uf;2024;68;442;187;1230;629;799
milha;4;uf;3;1;1;1;0;2;1
mimoso do sul;3;uf;2480;123;625;271;1377;896;1224
minador do negrao;4;uf;65;2;13;8;39;21;31
minas do leao;4;uf;660;11;127;57;455;184;224
mineiros;3;uf;1896;81;466;168;1125;634;832
miracatu;1;uf;12206;257;1653;810;8957;2463;6444
miracema do tocantins;4;uf;245;18;44;27;143;71;97
miradouro;3;uf;1049;48;385;88;503;473;520
miranda;3;uf;1631;53;460;167;927;627;685
miranda do norte;3;uf;815;60;154;113;433;267;356
mirandiba;4;uf;160;18;32;12;85;44;74
miranorte;4;uf;884;28;222;99;508;321;354
mirassol;4;uf;259;9;55;19;165;74;126
mirassol doeste;4;uf;152;7;48;18;76;66;71
moema;4;uf;459;16;132;51;255;183;249
mogeiro;4;uf;11;0;3;1;7;4;8
mogi das cruzes;4;uf;1;0;1;0;0;1;1
mojui dos campos;4;uf;3;0;3;0;0;3;1
moncao;4;uf;13;1;1;3;5;4;4
monsenhor gil;3;uf;753;57;148;104;415;252;355
monsenhor hipolito;4;uf;84;17;18;14;26;32;35
monsenhor paulo;4;uf;90;3;36;10;39;46;50
monte alegre de minas;5;uf;4571;93;1132;370;2893;1502;2357
monte alegre do piaui;4;uf;123;9;44;9;57;53;52
monte alegre dos campos;4;uf;131;1;48;12;68;60;63
monte carlo;4;uf;8;0;3;1;4;4;4
monte carmelo;3;uf;934;51;304;67;488;371;362
monte castelo;3;uf;1742;53;403;205;1031;608;876
monte negro;4;uf;76;5;32;13;24;45;38
monteiro;4;uf;205;41;46;38;68;84;82
montenegro;3;uf;1868;41;423;146;1212;569;989
montes altos;4;uf;1;0;0;0;1;0;1
montes claros;5;uf;5731;174;1831;676;2901;2507;2499
montes claros de goias;4;uf;466;44;118;81;210;199;168
morada nova;4;uf;493;21;89;85;281;174;197
moreno;3;uf;2548;55;593;195;1510;788;1271
mormaco;4;uf;227;2;51;12;157;63;99
morpara;4;uf;2;0;0;0;2;0;1
morretes;5;uf;6164;100;1291;367;4216;1658;3273
morrinhos;3;uf;3376;89;924;222;2028;1146;1650
morrinhos;3;uf;3376;89;924;222;2028;1146;1650
morro da fumaca;4;uf;10;0;1;1;7;2;5
morro da garca;4;uf;3;0;1;0;2;1;1
morro redondo;4;uf;384;12;87;25;251;112;231
morro reuter;4;uf;653;13;155;61;419;216;298
morros;4;uf;87;13;22;16;27;38;31
mossoro;1;uf;12435;289;3389;1157;6604;4546;5721
mostardas;4;uf;57;0;29;8;18;37;23
mucajai;4;uf;197;20;41;24;102;65;60
mucuri;3;uf;2146;95;408;218;1353;626;830
muitos capoes;4;uf;870;23;254;69;502;323;486
muliterno;4;uf;40;3;12;3;21;15;24
mundo novo;3;uf;2712;35;391;91;2105;482;1152
mundo novo;3;uf;2712;35;391;91;2105;482;1152
muniz freire;4;uf;314;9;82;47;161;129;176
muquem de sao francisco;4;uf;156;5;63;10;75;73;64
muquem do sao francisco;3;uf;1067;72;277;77;588;354;395
muqui;4;uf;274;19;99;61;83;160;147
muriae;5;uf;7770;140;2535;586;4255;3121;3665
muribeca;4;uf;274;12;73;17;157;90;123
murici;4;uf;773;40;190;168;331;358;353
muritiba;4;uf;382;19;85;26;227;111;165
mutuipe;4;uf;82;7;26;19;23;45;36
muzambinho;4;uf;180;2;60;32;81;92;74
naque;4;uf;645;20;132;54;420;186;290
natal;1;uf;22306;138;2546;1063;17518;3609;10065
natividade;4;uf;1;0;1;0;0;1;1
navegantes;5;uf;5924;119;1467;594;3530;2061;2729
navirai;4;uf;945;22;243;41;600;284;487
nazare;4;uf;109;6;30;16;49;46;49
nazare;4;uf;109;6;30;16;49;46;49
nazare da mata;4;uf;404;31;93;63;177;156;162
nazare do piaui;4;uf;181;18;41;33;78;74;96
nepomuceno;4;uf;491;9;112;14;348;126;331
nilopolis;4;uf;2;0;0;0;2;0;1
nioaque;4;uf;536;23;148;73;271;221;258
niquelandia;4;uf;317;42;108;57;94;165;129
nisia floresta;4;uf;18;0;4;1;12;5;8
niteroi;1;uf;18442;56;1974;251;15572;2225;8044
nobres;3;uf;2024;52;362;89;1488;451;987
normandia;4;uf;9;0;4;0;3;4;3
nossa senhora de lourdes;4;uf;1;0;1;0;0;1;1
nossa senhora de nazare;4;uf;1;0;0;0;1;0;1
nossa senhora do livramento;3;uf;876;45;272;113;426;385;368
nossa senhora do socorro;5;uf;7537;122;1672;446;4903;2118;3494
nova alvorada do sul;5;uf;4404;174;860;321;2924;1181;1925
nova andradina;4;uf;1220;36;213;99;833;312;578
nova aurora;4;uf;8;0;2;4;2;6;3
nova brasilandia;4;uf;8;0;4;0;4;4;3
nova era;5;uf;3874;93;1158;431;2132;1589;1822
nova erechim;4;uf;1063;37;304;107;593;411;449
nova esperanca;4;uf;1188;27;313;140;658;453;530
nova fatima;4;uf;718;34;126;52;468;178;202
nova floresta;4;uf;25;6;4;7;5;11;10
nova friburgo;4;uf;1;0;0;0;1;0;1
nova gloria;3;uf;911;65;197;144;479;341;361
nova granada;3;uf;1487;42;356;99;940;455;720
nova iguacu;1;uf;17394;242;2493;594;12672;3087;7496
nova itaberaba;4;uf;869;10;238;59;552;297;403
nova itarana;3;uf;1345;83;197;73;945;270;561
nova lacerda;4;uf;405;41;85;38;231;123;197
nova laranjeiras;3;uf;1633;86;404;137;950;541;854
nova lima;5;uf;6878;137;1611;743;4149;2354;3198
nova londrina;4;uf;275;8;77;34;146;111;116
nova mamore;4;uf;31;5;10;5;8;15;11
nova marilandia;4;uf;4;0;2;0;1;2;3
nova maringa;4;uf;6;0;3;1;2;4;2
nova mutum;3;uf;3527;127;864;216;2246;1080;1701
nova olinda;3;uf;1270;81;256;131;769;387;517
nova olinda do maranhao;4;uf;248;25;64;36;109;100;132
nova petropolis;4;uf;1225;8;248;50;892;298;664
nova ponte;4;uf;192;6;93;31;60;124;106
nova prata;4;uf;347;3;134;23;168;157;128
nova rosalandia;4;uf;346;17;76;52;189;128;124
nova santa helena;4;uf;473;12;119;27;307;146;211
nova santa rita;3;uf;2444;40;462;136;1749;598;1158
nova santa rita;3;uf;2444;40;462;136;1749;598;1158
nova santa rosa;4;uf;2;0;0;0;2;0;1
nova serrana;5;uf;3927;124;1176;506;1989;1682;1808
nova serrana;5;uf;3927;124;1176;506;1989;1682;1808
nova soure;4;uf;282;10;77;48;124;125;104
nova timboteua;4;uf;57;8;4;12;31;16;23
nova uniao;3;uf;2584;66;529;283;1654;812;1094
nova vicosa;3;uf;2684;105;593;317;1563;910;1137
nova xavantina;4;uf;560;40;158;84;254;242;247
novo cabrais;4;uf;57;3;23;7;23;30;26
novo hamburgo;3;uf;5263;67;800;174;4093;974;2403
novo lino;4;uf;747;46;124;124;414;248;369
novo progresso;4;uf;38;2;12;7;16;19;15
novo repartimento;4;uf;222;22;72;28;95;100;81
novo santo antonio;4;uf;4;0;0;0;4;0;2
ocara;4;uf;282;10;43;30;189;73;123
ocaucu;4;uf;819;18;221;42;508;263;423
oeiras;3;uf;549;86;149;103;167;252;221
oiapoque;4;uf;316;6;92;31;172;123;108
olaria;4;uf;144;11;56;11;65;67;86
olho dagua;4;uf;157;16;42;20;66;62;70
olho dagua das cunhas;4;uf;110;22;20;13;44;33;57
olho dagua do piaui;4;uf;35;0;7;7;19;14;16
olinda;4;uf;2;0;0;0;2;0;1
olindina;4;uf;304;30;79;39;128;118;116
oliveira;5;uf;4065;92;1237;207;2453;1444;2286
oliveira de fatima;4;uf;135;10;36;21;67;57;54
oliveira dos brejinhos;4;uf;870;50;275;43;474;318;339
oliveira fortes;4;uf;1442;16;427;75;902;502;885
onda verde;4;uf;1053;14;255;75;672;330;501
orizania;4;uf;593;43;167;81;285;248;279
oroco;4;uf;290;28;75;23;144;98;115
ortigueira;5;uf;3413;114;924;368;1902;1292;1701
osasco;4;uf;3;0;1;0;1;1;2
osorio;3;uf;2866;32;741;181;1851;922;1492
otacilio costa;4;uf;8;0;2;0;6;2;5
ourem;4;uf;33;1;9;12;8;21;10
ouricuri;3;uf;1147;76;290;170;513;460;551
ourinhos;4;uf;538;11;115;35;362;150;282
ouro branco;4;uf;267;16;64;39;138;103;96
ouro preto;3;uf;2012;32;361;139;1425;500;926
ouro preto do oeste;3;uf;2404;84;596;258;1391;854;1003
pacaja;4;uf;84;6;12;8;49;20;40
pacajus;3;uf;1552;59;289;169;959;458;629
pacaraima;4;uf;284;27;62;35;137;97;101
pacatuba;4;uf;2;0;0;0;2;0;1
padre bernardo;3;uf;865;113;271;137;288;408;356
padre carvalho;4;uf;516;57;133;80;231;213;230
padre paraiso;3;uf;972;54;339;120;427;459;426
palestina;4;uf;2;0;1;0;1;1;1
palestina do para;4;uf;30;5;9;0;14;9;18
palhano;4;uf;17;1;3;2;9;5;12
palhoca;2;uf;28018;229;6486;1926;18441;8412;13075
palmares;4;uf;802;52;172;99;423;271;349
palmares do sul;4;uf;62;3;22;6;28;28;27
palmas;4;uf;7;0;0;2;5;2;3
palmas;4;uf;7;0;0;2;5;2;3
palmas de monte alto;4;uf;2;0;0;1;1;1;1
palmeira;5;uf;3201;136;851;321;1789;1172;1441
palmeira das missoes;4;uf;1103;34;335;69;648;404;506
palmeira dos indios;3;uf;1188;41;331;157;574;488;490
palmeirais;4;uf;2;0;1;1;0;2;1
palmeirante;4;uf;3;0;0;1;2;1;1
palmeiras;4;uf;872;39;246;56;513;302;374
palmeiras do tocantins;4;uf;669;19;158;70;408;228;307
palmital;4;uf;61;10;17;11;22;28;32
palmitos;4;uf;399;8;105;30;250;135;207
panama;4;uf;340;4;104;35;192;139;193
panambi;3;uf;1896;57;476;124;1192;600;815
panelas;4;uf;456;68;113;57;183;170;224
pantano grande;4;uf;1550;19;293;104;1101;397;653
papanduva;3;uf;1110;53;338;123;555;461;489
para de minas;3;uf;2096;51;642;209;1142;851;1028
paracambi;4;uf;731;23;118;19;543;137;435
paracatu;5;uf;5232;107;1471;361;3100;1832;2115
paragominas;4;uf;754;52;203;96;357;299;346
paraiba do sul;3;uf;1739;35;229;124;1284;353;845
paraibano;4;uf;83;12;16;14;34;30;50
paraiso;4;uf;118;2;40;25;44;65;47
paraiso das aguas;4;uf;88;4;40;20;24;60;33
paraiso do sul;4;uf;5;0;1;1;3;2;2
paraiso do tocantins;3;uf;1475;58;339;180;858;519;616
parambu;4;uf;49;11;13;4;19;17;28
parana;4;uf;1;0;0;0;1;0;1
paranagua;5;uf;7938;142;1767;564;5104;2331;3998
paranaiba;3;uf;2179;79;519;269;1247;788;1027
paranaiguara;4;uf;304;8;98;28;164;126;143
paranatama;4;uf;359;38;78;57;159;135;138
paranavai;3;uf;1414;49;428;136;741;564;627
paraopeba;3;uf;2423;63;662;256;1356;918;1172
parati;3;uf;2582;57;597;219;1630;816;1171
paraty;4;uf;291;6;102;33;141;135;120
parau;4;uf;2;0;0;0;1;0;1
pariconha;4;uf;68;6;10;8;42;18;24
pariquera-acu;4;uf;1007;23;222;60;659;282;588
parnaiba;5;uf;3722;99;998;493;1912;1491;1710
parnamirim;1;uf;12675;167;2112;744;8985;2856;5746
parnamirim;1;uf;12675;167;2112;744;8985;2856;5746
passa quatro;4;uf;2;0;0;0;2;0;2
passagem franca do piaui;4;uf;261;15;53;33;144;86;136
passo de torres;4;uf;397;6;116;25;240;141;226
passo fundo;3;uf;4222;55;771;209;3066;980;1994
passos maia;4;uf;2;1;0;0;1;0;1
pastos bons;4;uf;143;16;42;28;50;70;64
pato branco;3;uf;2730;32;666;190;1732;856;1196
patos;3;uf;1557;67;444;230;725;674;697
patos de minas;3;uf;3028;102;915;205;1717;1120;1407
patos do piaui;4;uf;102;7;28;19;42;47;58
patrocinio;3;uf;2730;92;824;171;1525;995;1182
patrocinio do muriae;4;uf;235;7;75;18;131;93;114
patu;4;uf;71;11;24;13;18;37;30
pau darco;4;uf;15;1;8;3;2;11;7
pau dos ferros;4;uf;399;27;88;77;162;165;181
paudalho;3;uf;2046;98;426;230;1132;656;857
paula freitas;4;uf;520;25;130;51;294;181;234
pauliceia;4;uf;50;0;18;0;31;18;7
paulista;3;uf;3229;69;582;222;2138;804;1484
paulista;3;uf;3229;69;582;222;2138;804;1484
paulistana;4;uf;95;21;21;14;33;35;48
paulo afonso;4;uf;1097;34;240;134;652;374;480
paulo frontin;4;uf;844;40;213;63;501;276;447
paulo lopes;3;uf;2624;54;679;251;1582;930;1385
paverama;4;uf;306;3;80;9;205;89;144
peabiru;4;uf;669;20;156;79;395;235;284
pedra;4;uf;394;29;90;99;152;189;162
pedra azul;4;uf;230;17;76;27;106;103;120
pedra branca;4;uf;115;15;26;13;58;39;55
pedra branca do amapari;4;uf;129;5;67;9;40;76;30
pedra preta;3;uf;2607;81;433;174;1873;607;1314
pedrao;4;uf;21;1;10;0;8;10;10
pedras de fogo;4;uf;30;1;10;2;16;12;14
pedreiras;4;uf;1;0;0;0;1;0;1
pedrinopolis;4;uf;65;6;19;16;22;35;24
pedro afonso;4;uf;6;0;1;2;2;3;3
pedro alexandre;4;uf;18;5;3;1;8;4;8
pedro avelino;4;uf;14;2;4;1;7;5;7
pedro canario;3;uf;1141;50;330;142;572;472;587
pedro gomes;4;uf;588;20;134;50;371;184;212
pedro ii;4;uf;227;26;48;37;91;85;113
pedro leopoldo;4;uf;8;1;1;1;5;2;3
pedro osorio;4;uf;559;24;156;50;320;206;234
peixe;4;uf;372;31;116;61;154;177;191
peixe-boi;4;uf;38;8;6;3;20;9;13
peixoto de azevedo;4;uf;473;29;124;66;232;190;191
peixoto de azevedo;4;uf;473;29;124;66;232;190;191
pejucara;4;uf;401;14;66;22;289;88;177
pelotas;5;uf;7149;122;1283;359;5184;1642;3377
penaforte;4;uf;227;22;30;21;140;51;102
penha;3;uf;2117;38;490;168;1361;658;1080
perdizes;4;uf;1125;32;303;117;647;420;575
perdoes;3;uf;3226;62;812;158;2120;970;1817
pereiro;4;uf;17;2;6;1;7;7;8
periquito;3;uf;1053;77;295;152;517;447;470
peritoro;3;uf;1188;88;231;157;650;388;553
perola doeste;4;uf;343;12;102;36;180;138;160
pescaria brava;4;uf;310;5;114;25;153;139;152
pesqueira;3;uf;1477;111;338;250;704;588;547
petrolandia;4;uf;520;40;118;92;198;210;175
petrolina;1;uf;11316;240;2326;1020;7032;3346;4991
petropolis;1;uf;15026;199;2990;722;10686;3712;8658
pianco;4;uf;331;33;67;51;105;118;108
picada cafe;4;uf;908;19;262;73;545;335;509
picarras;3;uf;1828;42;366;152;1204;518;933
picos;5;uf;4354;176;921;662;2281;1583;2010
piedade de caratinga;4;uf;233;6;77;45;99;122;127
pilar;3;uf;3341;100;808;366;1855;1174;1657
pimenta bueno;5;uf;4147;93;1191;360;2357;1551;1975
pindamonhangaba;5;uf;6456;97;1200;218;4513;1418;2846
pindare mirim;4;uf;65;4;16;13;30;29;29
pindare-mirim;4;uf;28;4;10;0;10;10;12
pindoba;4;uf;1;0;0;0;1;0;1
pinhais;4;uf;19;0;5;0;14;5;10
pinhalzinho;3;uf;1618;53;413;204;902;617;752
pinheiral;4;uf;51;1;19;3;26;22;23
pinheiro machado;4;uf;473;14;121;34;296;155;242
pinheiros;4;uf;137;11;31;25;64;56;60
pio ix;4;uf;82;12;31;11;22;42;26
pio xii;4;uf;332;39;91;47;134;138;151
piquete;4;uf;1047;14;320;101;582;421;558
piracanjuba;3;uf;1370;36;371;118;819;489;688
piracuruca;4;uf;414;33;117;49;199;166;181
pirai;5;uf;11747;131;1539;300;9403;1839;6895
piranguinho;4;uf;725;27;233;102;344;335;338
piranhas;4;uf;283;21;70;39;140;109;148
pirapora;3;uf;941;48;353;146;361;499;451
piraquara;4;uf;1271;30;347;88;754;435;713
piraque;4;uf;29;1;7;5;16;12;20
piratini;4;uf;575;14;111;50;392;161;330
pirenopolis;3;uf;938;47;263;118;467;381;395
piripiri;3;uf;1368;68;352;168;712;520;706
piuma;4;uf;5;0;2;0;3;2;2
placas;4;uf;11;0;2;0;6;2;5
placido de castro;4;uf;168;10;35;16;102;51;77
planaltina;4;uf;4;0;1;1;2;2;3
planalto;3;uf;1789;72;418;163;1062;581;740
planalto;3;uf;1789;72;418;163;1062;581;740
planura;4;uf;807;20;202;116;448;318;324
pocinhos;4;uf;752;28;204;70;410;274;324
poco branco;4;uf;139;17;30;14;71;44;65
poco dantas;4;uf;5;1;0;2;1;2;3
poco das trincheiras;4;uf;192;12;44;33;80;77;62
pocoes;3;uf;1457;68;346;112;867;458;625
pocone;3;uf;1530;71;334;173;922;507;775
pocos de caldas;3;uf;1758;38;522;177;978;699;855
pocrane;4;uf;50;0;20;10;20;30;21
pojuca;4;uf;17;0;9;1;7;10;7
pombal;3;uf;1699;72;541;262;697;803;800
pombos;3;uf;1646;73;324;184;951;508;750
pomerode;4;uf;4;0;0;0;4;0;2
pompeu;4;uf;2;0;1;1;0;2;2
ponta grossa;1;uf;11248;294;2590;854;7075;3444;5088
ponta pora;3;uf;2592;66;616;269;1563;885;1004
pontal do araguaia;4;uf;49;0;17;2;27;19;19
pontalina;4;uf;12;0;1;0;10;1;6
ponte alta;3;uf;2191;60;586;193;1287;779;1194
ponte alta do norte;4;uf;614;26;190;41;335;231;326
ponte serrada;3;uf;2363;86;654;256;1329;910;1063
pontes e lacerda;3;uf;2293;78;567;237;1351;804;946
ponto dos volantes;3;uf;843;56;246;104;409;350;387
ponto novo;4;uf;555;60;102;60;297;162;214
porangatu;3;uf;2439;116;661;263;1326;924;1017
porteirao;4;uf;39;3;4;5;26;9;20
portelandia;4;uf;374;37;115;44;169;159;143
porto acre;4;uf;86;4;24;15;36;39;35
porto alegre;1;uf;15750;144;2488;458;12206;2946;7501
porto alegre do norte;4;uf;14;0;2;0;12;2;2
porto amazonas;4;uf;480;13;128;33;293;161;229
porto belo;3;uf;2802;25;681;149;1852;830;1524
porto esperidiao;4;uf;654;35;207;58;331;265;274
porto franco;3;uf;1221;63;323;116;657;439;548
porto grande;3;uf;1025;40;329;155;456;484;365
porto murtinho;4;uf;178;8;70;25;71;95;86
porto real;3;uf;1958;38;256;62;1513;318;998
porto real do colegio;3;uf;1349;60;292;129;771;421;625
porto seguro;3;uf;3669;103;787;328;2298;1115;1530
porto uniao;4;uf;188;7;56;19;94;75;82
porto velho;2;uf;31975;378;7503;2165;20390;9668;13101
porto vitoria;4;uf;1189;30;243;88;796;331;548
porto xavier;4;uf;125;11;37;21;56;58;49
posse;3;uf;1542;88;482;179;752;661;536
pouso alegre;5;uf;6598;90;1657;521;4087;2178;3299
pouso alto;3;uf;2017;33;580;116;1249;696;1004
pouso novo;3;uf;1543;52;370;102;995;472;816
pouso redondo;5;uf;6597;175;1828;538;3878;2366;3092
poxoreo;4;uf;364;17;108;29;202;137;178
pracuuba;4;uf;24;2;5;1;14;6;9
prado;4;uf;34;2;10;5;16;15;18
pranchita;4;uf;419;11;100;53;242;153;181
prata;3;uf;3061;137;676;267;1910;943;1401
presidente castelo branco;4;uf;614;8;160;57;369;217;278
presidente dutra;4;uf;98;17;27;16;35;43;45
presidente figueiredo;3;uf;1559;60;416;154;788;570;536
presidente getulio;4;uf;2;0;0;0;2;0;1
presidente juscelino;4;uf;2;0;0;0;1;0;1
presidente kennedy;4;uf;378;18;73;50;227;123;167
presidente kennedy;4;uf;378;18;73;50;227;123;167
presidente medici;3;uf;2311;103;639;268;1253;907;1005
presidente medici;3;uf;2311;103;639;268;1253;907;1005
presidente olegario;4;uf;4;0;2;0;2;2;3
presidente tancredo neves;3;uf;996;96;212;143;469;355;362
presidente vargas;4;uf;23;5;7;1;8;8;12
primavera;4;uf;1;0;0;0;1;0;1
primavera do leste;3;uf;2905;62;787;277;1709;1064;1284
primeira cruz;4;uf;10;2;5;1;1;6;4
professor jamil;3;uf;2245;43;584;173;1390;757;1153
promissao;4;uf;943;36;304;78;498;382;446
propria;4;uf;483;17;106;32;312;138;224
prudentopolis;3;uf;2403;119;690;266;1249;956;1077
pugmil;4;uf;551;24;135;81;284;216;218
puxinana;4;uf;3;0;1;1;1;2;2
quarai;4;uf;149;9;43;24;70;67;66
quatro barras;3;uf;1312;36;352;81;772;433;688
quatro irmaos;4;uf;7;1;0;1;5;1;3
quatro pontes;4;uf;385;5;71;26;273;97;140
quebrangulo;4;uf;3;0;2;0;1;2;1
queimadas;3;uf;2079;57;513;268;1101;781;962
queimados;3;uf;3382;119;615;226;2212;841;1646
queluz;4;uf;1629;28;288;62;1200;350;911
querencia;4;uf;4;0;1;3;0;4;1
quijingue;4;uf;168;14;59;19;70;78;51
quipapa;4;uf;306;10;102;37;141;139;143
quirinopolis;4;uf;2;0;0;0;2;0;1
quissama;4;uf;136;13;28;14;74;42;56
quitandinha;3;uf;1409;60;347;177;753;524;661
quixaba;4;uf;314;23;78;39;164;117;124
quixabeira;4;uf;8;0;1;2;5;3;1
rafael fernandes;4;uf;129;16;34;43;27;77;55
rafael jambeiro;3;uf;1663;88;382;112;1019;494;711
ramilandia;4;uf;2;0;0;0;2;0;1
rancho alegre doeste;4;uf;2;2;0;0;0;0;1
rancho queimado;3;uf;2530;66;742;260;1418;1002;1335
raul soares;4;uf;1;0;0;0;1;0;1
realeza;4;uf;456;6;97;32;316;129;172
reboucas;4;uf;338;10;104;59;136;163;171
recife;1;uf;29322;237;4155;1109;22245;5264;12691
redencao;4;uf;73;3;28;11;30;39;30
redencao do gurgueia;4;uf;214;21;62;19;109;81;55
reduto;4;uf;775;34;264;95;352;359;361
regeneracao;4;uf;130;9;46;28;43;74;51
registro;5;uf;5267;106;1300;310;3293;1610;2800
remanso;4;uf;3;0;0;1;0;1;2
remigio;4;uf;528;24;139;119;216;258;237
resende;5;uf;7272;129;1114;294;5419;1408;3689
ressaquinha;4;uf;1085;30;356;85;579;441;513
riachao;4;uf;425;35;113;56;191;169;201
riachao;4;uf;425;35;113;56;191;169;201
riachao das neves;3;uf;957;58;320;71;464;391;365
riachao do bacamarte;4;uf;492;26;158;55;236;213;285
riachao do jacuipe;3;uf;964;74;208;148;462;356;371
riachao do poco;4;uf;237;13;63;28;118;91;132
riacho de santana;4;uf;28;5;3;7;12;10;11
riachuelo;4;uf;462;30;100;60;252;160;234
rialma;3;uf;1849;106;506;270;908;776;742
rianapolis;4;uf;972;23;211;138;581;349;389
ribamar fiquene;4;uf;594;44;173;80;249;253;199
ribas do rio pardo;3;uf;2203;90;567;245;1228;812;899
ribeira do amparo;4;uf;98;9;21;16;43;37;42
ribeira do piaui;4;uf;2;0;0;0;2;0;2
ribeira do pombal;3;uf;1628;71;436;197;831;633;656
ribeirao;4;uf;760;35;175;106;406;281;399
ribeirao cascalheira;4;uf;410;35;152;52;157;204;181
ribeirao das neves;5;uf;8769;117;2039;821;5489;2860;3798
ribeirao do sul;4;uf;101;2;30;8;58;38;45
ribeirao vermelho;4;uf;467;4;83;10;367;93;271
ribeiropolis;4;uf;2;0;0;1;1;1;1
rio azul;4;uf;248;9;77;39;111;116;127
rio bonito;5;uf;5734;150;995;438;3957;1433;2708
rio bonito do iguacu;4;uf;405;23;158;40;172;198;185
rio branco;5;uf;8491;116;2342;819;4865;3161;3539
rio branco do sul;4;uf;28;5;9;3;11;12;13
rio brilhante;3;uf;2582;70;654;276;1528;930;1082
rio casca;3;uf;1667;34;411;172;991;583;830
rio crespo;4;uf;62;2;8;1;45;9;25
rio das flores;4;uf;16;0;3;1;10;4;8
rio das ostras;4;uf;604;23;114;68;375;182;308
rio das pedras;4;uf;1;0;0;0;1;0;1
rio de janeiro;1;uf;17834;155;2654;495;13679;3149;7752
rio do fogo;4;uf;140;7;34;35;55;69;64
rio do sul;5;uf;8427;101;1801;429;5837;2230;3895
rio dos bois;4;uf;781;43;204;85;429;289;333
rio grande;5;uf;7229;142;1452;394;4995;1846;3552
rio largo;3;uf;2629;104;515;438;1364;953;1124
rio manso;4;uf;434;8;85;18;315;103;225
rio maria;4;uf;32;1;8;0;22;8;13
rio negrinho;5;uf;4488;43;1179;365;2805;1544;2022
rio negro;4;uf;1277;30;306;96;785;402;645
rio novo do sul;3;uf;2560;81;579;243;1554;822;1255
rio pardo;3;uf;1844;43;468;155;1133;623;852
rio piracicaba;4;uf;6;0;3;0;2;3;4
rio preto;4;uf;4;0;3;0;1;3;1
rio preto da eva;4;uf;5;0;3;0;2;3;3
rio real;4;uf;732;59;169;82;368;251;348
rio rufino;4;uf;7;0;2;1;4;3;4
rio tinto;4;uf;29;0;15;2;11;17;17
rio verde;5;uf;7394;147;1682;576;4700;2258;3416
rio verde de mato grosso;3;uf;2593;77;611;259;1566;870;1103
rio vermelho;4;uf;1;0;0;0;1;0;1
roca sales;4;uf;2;0;0;0;2;0;1
rodeio;3;uf;1672;35;578;172;845;750;761
rodolfo fernandes;4;uf;19;0;8;2;9;10;6
rolandia;3;uf;2414;35;627;278;1345;905;1056
romaria;4;uf;333;7;107;42;167;149;146
roncador;4;uf;8;2;4;2;0;6;2
rondolandia;4;uf;2;0;2;0;0;2;1
rondon do para;4;uf;315;18;99;55;117;154;114
rondonopolis;5;uf;8057;166;1758;520;5460;2278;3725
roque gonzales;4;uf;211;19;85;31;74;116;71
rorainopolis;4;uf;451;46;174;50;96;224;123
rosario;4;uf;259;24;50;50;115;100;104
rosario do catete;4;uf;1266;35;214;94;848;308;530
rosario do sul;3;uf;2303;55;478;182;1561;660;798
rosario oeste;3;uf;2193;71;438;153;1496;591;1173
roseira;4;uf;1216;31;232;55;811;287;624
rubelita;4;uf;5;0;3;0;2;3;2
ruropolis;4;uf;57;5;17;5;27;22;25
russas;3;uf;1897;94;396;271;1050;667;879
ruy barbosa;4;uf;338;18;87;18;202;105;142
sabara;1;uf;10979;228;2177;1290;7080;3467;4656
sacramento;4;uf;370;24;94;40;205;134;143
sagrada familia;4;uf;92;3;24;8;57;32;41
saire;4;uf;452;15;113;44;241;157;233
saldanha marinho;4;uf;397;9;96;28;258;124;214
salgueiro;3;uf;2825;132;765;322;1455;1087;1295
salinas;3;uf;1371;106;402;144;680;546;606
saloa;4;uf;200;21;43;41;84;84;115
salto grande;4;uf;210;7;76;14;105;90;96
salvador;1;uf;15000;197;2569;498;10868;3067;6456
salvador das missoes;4;uf;71;4;26;11;30;37;33
salvador do sul;4;uf;69;0;21;11;31;32;34
sambaiba;4;uf;7;0;1;0;5;1;5
sangao;3;uf;2188;46;680;204;1186;884;1142
sanharo;4;uf;546;45;130;66;275;196;212
santa barbara;3;uf;1353;88;306;173;694;479;568
santa barbara;3;uf;1353;88;306;173;694;479;568
santa barbara do leste;4;uf;739;35;245;88;359;333;366
santa barbara do sul;4;uf;409;25;112;36;234;148;181
santa barbara do tugurio;4;uf;1;0;1;0;0;1;1
santa brigida;4;uf;199;10;47;26;103;73;94
santa carmem;4;uf;7;0;1;1;5;2;3
santa cecilia;3;uf;2237;70;564;220;1319;784;1124
santa cruz;3;uf;901;53;224;150;415;374;392
santa cruz cabralia;4;uf;2;1;0;0;1;0;1
santa cruz de salinas;4;uf;256;16;84;27;123;111;119
santa cruz do capibaribe;4;uf;1;0;1;0;0;1;1
santa cruz do sul;3;uf;2698;37;725;274;1590;999;1134
santa cruz do xingu;4;uf;1;0;0;0;1;0;1
santa efigenia de minas;4;uf;1;0;0;0;1;0;1
santa fe de goias;4;uf;23;2;5;9;7;14;6
santa filomena;4;uf;10;2;6;0;2;6;4
santa helena;4;uf;1;1;0;0;0;0;1
santa helena de goias;4;uf;262;6;53;19;177;72;121
santa ines;3;uf;1950;109;371;283;1058;654;922
santa ines;3;uf;1950;109;371;283;1058;654;922
santa isabel;3;uf;3140;58;527;106;2294;633;1697
santa isabel do para;3;uf;2032;53;435;197;1229;632;1004
santa izabel do para;4;uf;314;15;102;41;142;143;146
santa juliana;4;uf;457;31;139;71;209;210;191
santa lucia;4;uf;780;16;168;38;536;206;353
santa luz;4;uf;89;7;21;7;52;28;36
santa luzia;3;uf;1700;106;433;237;821;670;758
santa luzia;3;uf;1700;106;433;237;821;670;758
santa luzia;3;uf;1700;106;433;237;821;670;758
santa luzia;3;uf;1700;106;433;237;821;670;758
santa luzia do itanhy;4;uf;673;50;152;87;350;239;319
santa luzia do norte;4;uf;4;0;0;1;3;1;2
santa luzia do para;4;uf;348;37;95;41;147;136;156
santa luzia do parua;4;uf;177;16;57;32;64;89;71
santa margarida;4;uf;22;2;5;3;11;8;11
santa margarida do sul;4;uf;468;10;94;39;317;133;186
santa maria;1;uf;15371;190;3347;901;10458;4248;6918
santa maria;1;uf;15371;190;3347;901;10458;4248;6918
santa maria da boa vista;4;uf;993;40;273;94;558;367;445
santa maria das barreiras;4;uf;22;2;3;4;12;7;9
santa maria de itabira;4;uf;4;1;0;1;1;1;1
santa maria de jetiba;4;uf;2;0;0;1;1;1;1
santa maria do oeste;4;uf;3;0;1;0;2;1;2
santa maria do para;3;uf;2648;125;468;294;1587;762;1103
santa maria madalena;4;uf;8;1;1;2;4;3;4
santa mariana;4;uf;643;31;164;82;346;246;248
santa quiteria do maranhao;4;uf;1;0;0;1;0;1;1
santa rita;5;uf;6719;214;1777;755;3597;2532;3290
santa rita;5;uf;6719;214;1777;755;3597;2532;3290
santa rita de caldas;4;uf;407;21;131;59;185;190;232
santa rita de cassia;4;uf;64;6;16;0;42;16;26
santa rita de minas;3;uf;1083;47;347;164;490;511;523
santa rita do araguaia;4;uf;503;13;114;46;316;160;236
santa rita do novo destino;4;uf;194;9;63;39;77;102;93
santa rita do sapucai;4;uf;983;28;280;143;511;423;484
santa rita do tocantins;4;uf;378;37;97;51;176;148;156
santa rosa;4;uf;722;41;225;103;341;328;266
santa rosa de goias;4;uf;1;0;1;0;0;1;1
santa rosa do sul;4;uf;911;31;278;56;521;334;451
santa teresinha;3;uf;951;65;212;118;493;330;383
santa teresinha;3;uf;951;65;212;118;493;330;383
santa tereza de goias;4;uf;813;33;231;96;427;327;351
santa tereza do oeste;3;uf;1694;59;481;168;888;649;692
santa terezinha;4;uf;5;0;1;3;1;4;1
santa terezinha de itaipu;3;uf;2307;45;571;181;1425;752;995
santa vitoria;4;uf;174;9;55;25;79;80;87
santa vitoria do palmar;3;uf;1023;47;278;86;591;364;471
santana;4;uf;30;2;7;4;17;11;11
santana da boa vista;4;uf;620;20;125;56;401;181;415
santana de pirapama;4;uf;6;0;1;1;4;2;2
santana do araguaia;4;uf;2;0;0;0;2;0;1
santana do ipanema;4;uf;832;33;221;148;385;369;342
santana do livramento;3;uf;2759;38;693;218;1763;911;1159
santana do matos;4;uf;4;0;1;0;3;1;2
santana do paraiso;3;uf;1931;62;549;203;1093;752;793
santana dos garrotes;4;uf;6;2;1;2;1;3;3
santarem;5;uf;3769;79;1366;426;1700;1792;1564
santarem;5;uf;3769;79;1366;426;1700;1792;1564
santiago;4;uf;1461;28;287;91;1024;378;605
santo amaro;4;uf;139;2;39;6;89;45;67
santo amaro da imperatriz;3;uf;1570;32;444;162;888;606;708
santo amaro das brotas;4;uf;8;0;1;0;7;1;4
santo amaro do maranhao;4;uf;9;4;2;3;0;5;5
santo angelo;4;uf;52;0;11;6;35;17;26
santo antonio da barra;4;uf;701;43;197;66;381;263;304
santo antonio da patrulha;3;uf;4204;47;1039;204;2832;1243;2212
santo antonio da platina;3;uf;1910;46;495;128;1160;623;837
santo antonio das missoes;4;uf;634;10;122;43;445;165;288
santo antonio de goias;4;uf;7;0;1;1;3;2;5
santo antonio de jesus;3;uf;2110;56;573;248;1152;821;943
santo antonio de lisboa;4;uf;163;13;21;25;97;46;56
santo antonio do amparo;5;uf;4751;88;1352;243;2986;1595;2979
santo antonio do descoberto;3;uf;1256;38;314;120;704;434;681
santo antonio do grama;4;uf;431;19;127;57;219;184;235
santo antonio do leverger;3;uf;3636;85;533;247;2703;780;1834
santo antonio do planalto;4;uf;386;18;105;29;226;134;170
santo antonio do rio abaixo;4;uf;3;0;1;0;2;1;3
santo antonio do sudoeste;4;uf;790;18;232;53;446;285;320
santo antonio dos lopes;4;uf;83;10;11;10;47;21;42
santo augusto;4;uf;63;1;26;9;26;35;28
santo cristo;4;uf;347;18;122;51;148;173;136
santo estevao;3;uf;2493;102;486;255;1479;741;1052
santos dumont;3;uf;3412;88;1088;231;1919;1319;1979
sao bentinho;4;uf;40;2;15;14;4;29;12
sao bento;4;uf;13;1;4;1;5;5;5
sao bento de pombal;4;uf;189;7;62;20;93;82;94
sao bento do sul;3;uf;1473;20;517;143;770;660;761
sao bento do tocantins;4;uf;27;3;4;9;7;13;11
sao bernardo do campo;4;uf;2;0;1;1;0;2;1
sao bonifacio;4;uf;4;0;0;0;4;0;1
sao borja;3;uf;1836;49;401;99;1249;500;828
sao bras;4;uf;3;0;2;0;1;2;1
sao caitano;3;uf;2167;87;429;222;1288;651;941
sao cristovao;3;uf;2342;69;456;161;1534;617;1037
sao cristovao do sul;3;uf;2575;71;682;209;1552;891;1372
sao desiderio;3;uf;1324;143;370;128;634;498;414
sao domingos;4;uf;20;2;8;3;7;11;8
sao domingos;4;uf;20;2;8;3;7;11;8
sao domingos;4;uf;20;2;8;3;7;11;8
sao domingos;4;uf;20;2;8;3;7;11;8
sao domingos;4;uf;20;2;8;3;7;11;8
sao domingos de pombal;4;uf;5;0;1;1;3;2;4
sao domingos do araguaia;4;uf;387;36;112;29;191;141;168
sao domingos do azeitao;4;uf;192;19;42;29;89;71;96
sao domingos do capim;4;uf;26;2;5;0;19;5;11
sao domingos do maranhao;4;uf;23;7;4;4;5;8;10
sao domingos do prata;3;uf;1823;81;482;221;986;703;915
sao felix;4;uf;1;0;0;0;1;0;1
sao felix de balsas;4;uf;57;7;14;4;30;18;30
sao felix do araguaia;4;uf;4;0;1;1;2;2;3
sao felix do coribe;4;uf;9;8;0;0;1;0;1
sao fernando;4;uf;4;0;0;1;1;1;2
sao francisco;4;uf;270;9;64;33;142;97;120
sao francisco;4;uf;270;9;64;33;142;97;120
sao francisco de assis do piaui;4;uf;2;0;0;0;2;0;2
sao francisco de goias;4;uf;684;21;163;100;382;263;296
sao francisco de paula;4;uf;113;2;23;4;83;27;59
sao francisco do brejao;4;uf;116;5;11;4;95;15;34
sao francisco do conde;4;uf;1;0;1;0;0;1;1
sao francisco do gloria;4;uf;706;17;218;63;392;281;332
sao francisco do guapore;4;uf;8;0;4;1;3;5;4
sao francisco do maranhao;4;uf;4;0;0;0;4;0;1
sao francisco do oeste;4;uf;85;16;21;16;22;37;41
sao francisco do para;4;uf;584;38;105;66;328;171;229
sao francisco do piaui;4;uf;39;3;9;2;16;11;21
sao francisco do sul;3;uf;2785;36;716;326;1623;1042;1296
sao gabriel;3;uf;1388;43;301;81;942;382;567
sao gabriel da palha;4;uf;2;0;0;0;2;0;1
sao gabriel do oeste;3;uf;2078;49;489;175;1308;664;922
sao geraldo do araguaia;4;uf;69;15;13;7;18;20;29
sao goncalo;1;uf;13634;244;2471;628;9689;3099;6193
sao goncalo do abaete;3;uf;1688;60;515;177;897;692;781
sao goncalo do amarante;5;uf;6318;109;1048;616;4188;1664;2824
sao goncalo do amarante;5;uf;6318;109;1048;616;4188;1664;2824
sao goncalo do gurgueia;4;uf;21;2;5;2;12;7;14
sao goncalo do para;4;uf;279;10;97;36;132;133;154
sao goncalo do piaui;4;uf;46;2;30;7;4;37;10
sao goncalo do rio abaixo;5;uf;5595;191;1645;699;2933;2344;2576
sao goncalo do sapucai;3;uf;3383;55;1073;226;1933;1299;1929
sao goncalo dos campos;4;uf;870;35;256;86;472;342;339
sao jeronimo;4;uf;44;1;5;2;35;7;22
sao joao;4;uf;251;7;58;24;143;82;111
sao joao batista;4;uf;2;0;0;0;1;0;1
sao joao da baliza;4;uf;5;1;2;0;2;2;2
sao joao da barra;3;uf;1084;51;299;114;570;413;457
sao joao da fronteira;4;uf;207;11;38;25;128;63;122
sao joao da varjota;4;uf;175;17;38;23;83;61;91
sao joao de meriti;5;uf;10521;94;1376;227;8186;1603;4527
sao joao de meriti;5;uf;10521;94;1376;227;8186;1603;4527
sao joao do araguaia;4;uf;227;23;60;22;109;82;96
sao joao do cariri;4;uf;199;17;76;24;75;100;95
sao joao do jaguaribe;4;uf;30;4;7;4;15;11;10
sao joao do manhuacu;3;uf;973;45;304;124;462;428;467
sao joao do piaui;4;uf;2;0;1;0;1;1;1
sao joao do rio do peixe;4;uf;281;26;64;66;102;130;145
sao joao do soter;4;uf;2;1;0;0;1;0;1
sao joao do sul;4;uf;490;10;143;26;298;169;268
sao joao dos patos;4;uf;231;27;55;29;105;84;121
sao joao nepomuceno;4;uf;2;0;1;0;1;1;2
sao joaquim de bicas;3;uf;1918;37;411;108;1281;519;942
sao jose;2;uf;44027;191;8828;1928;31326;10756;20102
sao jose da laje;4;uf;613;33;145;131;273;276;299
sao jose da vitoria;3;uf;1571;65;393;140;924;533;788
sao jose das missoes;4;uf;257;14;77;27;134;104;126
sao jose de espinharas;4;uf;92;5;33;14;33;47;42
sao jose de mipibu;3;uf;2471;58;585;227;1453;812;1263
sao jose de piranhas;4;uf;9;0;4;2;1;6;3
sao jose de ribamar;4;uf;2;0;2;0;0;2;1
sao jose do belmonte;4;uf;199;17;35;19;115;54;88
sao jose do cedro;4;uf;886;23;238;76;530;314;366
sao jose do cerrito;3;uf;1032;49;350;139;469;489;517
sao jose do goiabal;4;uf;13;0;1;1;11;2;7
sao jose do herval;4;uf;731;27;170;71;438;241;356
sao jose do inhacora;4;uf;7;1;2;1;3;3;4
sao jose do jacuipe;4;uf;395;22;51;36;184;87;103
sao jose do norte;4;uf;30;10;1;9;10;10;10
sao jose do ouro;4;uf;7;0;2;0;5;2;3
sao jose do rio pardo;4;uf;2;0;0;0;2;0;1
sao jose do rio preto;1;uf;11216;134;2574;525;7588;3099;5074
sao jose do sul;4;uf;92;5;33;12;42;45;48
sao jose do vale do rio preto;4;uf;14;0;7;0;6;7;5
sao jose dos ausentes;4;uf;66;2;25;7;23;32;27
sao jose dos campos;1;uf;23387;204;3339;639;17757;3978;9805
sao jose dos pinhais;1;uf;22301;361;4322;1347;15197;5669;10670
sao juliao;4;uf;36;1;4;4;23;8;20
sao leopoldo;1;uf;16370;98;2134;410;13352;2544;7528
sao lourenco;4;uf;399;7;161;34;186;195;202
sao lourenco da mata;3;uf;1865;56;457;157;1072;614;846
sao lourenco da serra;3;uf;3302;103;624;211;2155;835;1727
sao lourenco do sul;4;uf;1036;40;232;83;659;315;478
sao luis;1;uf;11417;173;1498;1117;8042;2615;5183
sao luis do curu;4;uf;562;29;148;81;281;229;240
sao luis gonzaga do maranhao;4;uf;16;1;3;0;11;3;10
sao luiz;4;uf;11;3;5;0;1;5;5
sao luiz do norte;4;uf;916;36;213;129;518;342;344
sao luiz gonzaga;3;uf;1445;69;445;112;786;557;569
sao mamede;4;uf;493;31;140;45;261;185;195
sao marcos;4;uf;1285;12;335;101;806;436;689
sao martinho;4;uf;57;0;16;4;36;20;21
sao mateus;5;uf;6557;122;1521;675;3932;2196;2923
sao mateus do maranhao;4;uf;529;47;111;80;256;191;228
sao mateus do sul;3;uf;2380;62;551;193;1485;744;1054
sao miguel da baixa grande;4;uf;4;0;0;3;1;3;2
sao miguel das matas;4;uf;5;0;1;0;4;1;2
sao miguel das missoes;4;uf;84;1;20;6;57;26;43
sao miguel de taipu;4;uf;646;13;212;80;322;292;386
sao miguel do araguaia;4;uf;51;11;7;21;10;28;18
sao miguel do guama;4;uf;604;57;128;82;283;210;237
sao miguel do guapore;4;uf;19;0;7;5;7;12;11
sao miguel do iguacu;3;uf;3327;89;912;292;1886;1204;1564
sao miguel do oeste;4;uf;590;1;176;51;323;227;247
sao miguel doeste;3;uf;1348;32;346;124;793;470;614
sao miguel dos campos;3;uf;2769;71;597;244;1698;841;1207
sao paulo;1;uf;15791;243;3372;588;10549;3960;7878
sao paulo das missoes;4;uf;2;0;0;0;2;0;1
sao paulo do potengi;4;uf;12;1;3;0;7;3;7
sao pedro;4;uf;198;15;62;27;88;89;84
sao pedro da cipa;4;uf;488;14;71;48;344;119;223
sao pedro da serra;4;uf;13;0;7;0;5;7;7
sao pedro das missoes;4;uf;14;2;7;1;3;8;6
sao pedro de alcantara;4;uf;2;0;1;0;1;1;1
sao pedro do butia;4;uf;103;4;31;19;48;50;44
sao pedro do piaui;4;uf;153;25;42;27;46;69;72
sao pedro do sul;4;uf;676;25;202;56;382;258;322
sao pedro do turvo;4;uf;241;9;37;22;165;59;113
sao pedro dos ferros;4;uf;3;0;3;0;0;3;1
sao rafael;4;uf;2;0;1;0;1;1;1
sao raimundo das mangabeiras;4;uf;357;36;119;57;132;176;156
sao raimundo nonato;4;uf;44;3;35;5;0;40;3
sao sebastiao;3;uf;1195;80;266;134;651;400;559
sao sebastiao da bela vista;3;uf;2479;46;721;183;1455;904;1184
sao sebastiao de lagoa de  roca;4;uf;51;2;12;9;18;21;18
sao sebastiao de lagoa de roca;4;uf;307;8;80;42;158;122;142
sao sebastiao do paraiso;4;uf;1;0;1;0;0;1;1
sao sebastiao do passe;5;uf;6070;107;1537;250;3860;1787;2921
sao sepe;3;uf;1273;48;360;120;705;480;669
sao simao;4;uf;734;24;197;53;438;250;329
sao tome;4;uf;5;0;4;1;0;5;1
sao vicente;4;uf;69;2;25;11;29;36;31
sao vicente do sul;4;uf;668;32;180;53;398;233;260
sapeacu;4;uf;396;22;81;62;214;143;173
sapezal;4;uf;14;4;4;3;3;7;7
sapucaia;5;uf;5079;134;1199;365;3243;1564;2445
sapucaia;5;uf;5079;134;1199;365;3243;1564;2445
sapucaia do sul;3;uf;4508;30;548;114;3680;662;2117
sarandi;5;uf;6268;86;1263;332;4359;1595;2703
sarandi;5;uf;6268;86;1263;332;4359;1595;2703
satiro dias;4;uf;4;1;0;0;3;0;3
satuba;3;uf;1893;43;492;247;983;739;774
satubinha;4;uf;23;2;4;1;15;5;18
saudade do iguacu;4;uf;206;4;82;26;90;108;94
saudades;4;uf;453;14;115;56;254;171;242
seabra;3;uf;1722;68;490;146;942;636;649
sebastiao leal;4;uf;5;0;1;2;2;3;2
seberi;4;uf;1113;40;295;85;667;380;515
selviria;4;uf;229;5;80;28;112;108;115
sena madureira;4;uf;545;27;145;75;264;220;195
senador alexandre costa;4;uf;22;3;7;2;6;9;10
senador eloi de souza;4;uf;118;17;24;19;47;43;53
senador georgino avelino;4;uf;4;0;2;0;2;2;3
senador guiomard;4;uf;561;25;155;84;266;239;233
senador jose bento;4;uf;412;14;152;44;193;196;239
senador pompeu;4;uf;5;2;1;2;0;3;2
senhor do bonfim;3;uf;1958;71;462;180;1119;642;704
sentinela do sul;4;uf;184;6;50;15;108;65;80
sericita;4;uf;2;0;0;1;1;1;1
seringueiras;4;uf;9;1;3;2;3;5;6
seritinga;4;uf;232;7;86;17;117;103;145
seropedica;5;uf;6817;122;1178;457;4673;1635;3261
serra;2;uf;38865;386;5287;3124;27859;8411;17338
serra branca;4;uf;166;24;43;38;54;81;71
serra caiada;4;uf;274;28;67;36;127;103;120
serra do navio;4;uf;10;0;3;4;3;7;4
serra negra do norte;4;uf;109;12;29;17;41;46;59
serra nova dourada;4;uf;3;0;0;3;0;3;1
serra talhada;5;uf;3246;105;1039;489;1435;1528;1386
serrinha;3;uf;1278;98;252;164;673;416;539
serrinha;3;uf;1278;98;252;164;673;416;539
serrinha dos pintos;4;uf;6;1;3;1;0;4;2
serrita;4;uf;3;0;1;0;2;1;1
sertania;3;uf;1322;75;296;232;646;528;679
sertanopolis;4;uf;3;0;1;0;1;1;2
sertao;4;uf;1;0;0;0;0;0;1
sertao santana;4;uf;35;0;25;2;7;27;6
sete de setembro;4;uf;112;5;49;14;41;63;48
sete lagoas;5;uf;5866;96;1702;462;3433;2164;2852
severiano de almeida;4;uf;434;16;94;38;279;132;250
severiano melo;4;uf;30;9;5;4;9;9;16
sidrolandia;4;uf;849;23;236;92;480;328;349
silva jardim;5;uf;4419;226;933;440;2652;1373;1871
silveiras;4;uf;565;5;108;27;413;135;334
simao pereira;4;uf;1268;13;374;68;795;442;785
simoes filho;5;uf;6337;64;1064;186;4715;1250;2723
simolandia;4;uf;649;26;193;61;345;254;276
simonesia;4;uf;1;0;1;0;0;1;1
simplicio mendes;4;uf;6;0;2;0;3;2;3
sinop;5;uf;5450;135;1466;541;3081;2007;2320
siriri;4;uf;2;0;0;0;2;0;1
sitio do quinto;4;uf;8;0;2;1;5;3;4
sitio novo;4;uf;102;10;27;12;51;39;27
sobrado;4;uf;779;31;208;80;419;288;412
sobral;3;uf;2516;98;599;391;1257;990;1066
soledade;3;uf;3246;102;688;243;2113;931;1437
soledade;3;uf;3246;102;688;243;2113;931;1437
soledade de minas;4;uf;41;0;11;0;29;11;20
solonopole;4;uf;8;2;4;1;1;5;2
sombrio;3;uf;2853;49;755;162;1805;917;1353
sonora;4;uf;692;30;169;81;389;250;289
sooretama;3;uf;2882;84;653;346;1670;999;1214
sorriso;5;uf;4358;104;1007;287;2817;1294;1997
sousa;3;uf;1552;102;398;306;626;704;696
sucupira;4;uf;4;1;1;1;1;2;2
sucupira do riachao;4;uf;35;1;14;2;16;16;17
sulina;4;uf;13;0;4;1;8;5;9
sume;4;uf;142;18;39;35;40;74;65
sumidouro;4;uf;9;0;5;0;4;5;6
tabai;4;uf;875;22;182;58;601;240;413
taboao da serra;5;uf;8248;88;1796;526;5305;2322;3470
taboao da serra;5;uf;8248;88;1796;526;5305;2322;3470
taboleiro grande;4;uf;24;5;10;4;4;14;15
tabuleiro do norte;4;uf;180;11;48;14;101;62;77
tacaimbo;4;uf;834;53;207;90;431;297;313
tacaratu;4;uf;5;0;2;2;1;4;4
taio;4;uf;6;0;1;1;4;2;3
taipu;4;uf;340;22;86;45;165;131;160
talisma;4;uf;395;14;94;42;240;136;168
tangara;4;uf;403;32;95;68;180;163;180
tangara da serra;4;uf;3;0;0;1;1;1;2
tangua;3;uf;1918;67;353;186;1208;539;939
tanque darca;4;uf;205;11;58;29;84;87;93
tanquinho;4;uf;524;43;146;80;225;226;231
taparuba;4;uf;21;2;8;6;4;14;10
tapaua;4;uf;1;0;1;0;0;1;1
tapejara;4;uf;2;0;0;0;2;0;1
tapes;3;uf;1345;48;243;123;896;366;631
taquarana;4;uf;7;0;2;2;0;4;2
taquari;4;uf;257;9;76;13;154;89;118
taquaritinga do norte;3;uf;851;79;202;165;352;367;331
tarauaca;4;uf;1;0;1;0;0;1;1
tartarugalzinho;4;uf;222;24;68;45;66;113;72
tarumirim;4;uf;352;25;123;51;144;174;157
taua;4;uf;207;36;54;37;66;91;87
taubate;5;uf;8861;90;1554;278;6272;1832;3920
tavares;4;uf;13;1;3;4;5;7;6
teixeira de freitas;5;uf;5044;142;955;497;3262;1452;2042
teixeira soares;4;uf;514;26;156;51;269;207;229
telemaco borba;4;uf;4;0;2;0;2;2;2
tenente laurentino cruz;4;uf;3;2;0;1;0;1;1
tenorio;4;uf;5;1;1;3;0;4;1
teodoro sampaio;4;uf;514;24;131;30;310;161;265
teofilandia;4;uf;433;31;87;62;228;149;178
teofilo otoni;5;uf;7378;198;1926;662;4346;2588;3482
teolandia;4;uf;424;23;101;61;211;162;180
teotonio vilela;3;uf;861;60;176;93;453;269;367
terenos;3;uf;2370;63;544;261;1430;805;935
teresina;2;uf;25851;377;4083;2336;17703;6419;11967
teresopolis;5;uf;5912;150;1886;611;3044;2497;2836
terezopolis de goias;3;uf;1723;33;372;153;1095;525;844
terra de areia;4;uf;1327;31;304;81;850;385;692
terra nova;4;uf;238;11;62;18;134;80;124
terra nova;4;uf;238;11;62;18;134;80;124
terra nova do norte;4;uf;715;38;196;90;371;286;302
terra nova do norte;4;uf;715;38;196;90;371;286;302
terra roxa;4;uf;824;17;192;57;521;249;343
tesouro;4;uf;4;0;1;0;3;1;1
teutonia;4;uf;4;0;1;0;3;1;2
theobroma;4;uf;6;1;2;1;1;3;3
tiangua;3;uf;2304;113;560;367;1110;927;999
tibagi;5;uf;3386;116;932;360;1906;1292;1582
tijucas;3;uf;3217;62;873;233;1947;1106;1742
tijucas do sul;5;uf;8757;96;1751;319;6386;2070;4681
timbauba;4;uf;151;13;37;21;66;58;59
timbauba dos batistas;4;uf;13;0;5;3;5;8;6
timbo;4;uf;9;0;1;2;6;3;5
timon;3;uf;1770;138;355;215;966;570;633
timoteo;4;uf;661;26;215;70;337;285;303
tio hugo;4;uf;844;21;188;67;534;255;373
tiradentes do sul;4;uf;150;8;69;25;43;94;66
tiros;4;uf;5;0;3;1;1;4;1
tocantinopolis;4;uf;20;1;2;2;14;4;8
toledo;3;uf;1857;63;470;149;1106;619;829
tomar do geru;4;uf;2;1;0;0;0;0;1
toritama;4;uf;802;21;153;72;475;225;337
torres;4;uf;1412;27;272;112;944;384;672
touros;4;uf;78;5;22;19;31;41;36
tracuateua;4;uf;246;18;70;38;99;108;100
tracunhaem;4;uf;213;15;57;32;90;89;90
trairao;4;uf;60;6;14;10;26;24;32
tres arroios;4;uf;328;13;70;29;200;99;156
tres barras;4;uf;570;19;173;91;273;264;272
tres cachoeiras;3;uf;1956;46;423;122;1313;545;976
tres coracoes;3;uf;3584;61;1092;230;2113;1322;1891
tres de maio;4;uf;448;27;159;53;198;212;200
tres forquilhas;4;uf;337;9;85;21;215;106;178
tres lagoas;5;uf;7173;99;1755;449;4642;2204;3079
tres marias;3;uf;2602;90;763;252;1451;1015;1141
tres passos;4;uf;619;21;269;91;221;360;222
tres rios;5;uf;5347;86;1134;275;3722;1409;2786
treze de maio;4;uf;62;2;19;6;33;25;35
trindade;3;uf;461;78;76;86;189;162;205
trindade;3;uf;461;78;76;86;189;162;205
triunfo;3;uf;2951;69;626;209;1986;835;1469
triunfo potiguar;4;uf;81;8;26;10;34;36;40
trombudo central;3;uf;1729;48;470;163;1002;633;751
tubarao;5;uf;7572;77;1937;399;4958;2336;3720
tucano;3;uf;1622;115;381;173;861;554;604
tucurui;4;uf;17;7;2;2;6;4;6
tufilandia;4;uf;11;1;2;1;6;3;6
tunas do parana;4;uf;305;12;98;41;130;139;143
tuneiras do oeste;4;uf;107;9;38;16;39;54;39
tuntum;4;uf;114;18;29;11;45;40;50
tupanci do sul;4;uf;16;0;8;0;8;8;7
tupancireta;4;uf;248;8;69;10;159;79;126
tupirama;4;uf;6;1;3;1;1;4;4
turucu;4;uf;407;13;86;25;277;111;182
tururu;4;uf;34;6;7;4;13;11;15
uaua;4;uf;6;3;0;0;0;0;3
ubaira;4;uf;63;15;19;16;12;35;26
ubaitaba;4;uf;637;60;149;69;313;218;271
ubajara;4;uf;98;9;20;11;54;31;41
ubaporanga;3;uf;1306;69;409;180;613;589;612
ubarana;4;uf;581;35;158;53;317;211;270
ubata;4;uf;215;10;87;37;72;124;85
ubatuba;5;uf;5230;47;1690;389;2919;2079;2303
uberaba;1;uf;10208;254;3303;927;5330;4230;5438
uberlandia;1;uf;21626;224;4639;1988;14016;6627;10556
ubirajara;4;uf;1;0;0;0;1;0;1
ubirata;4;uf;861;34;238;92;471;330;388
uirauna;4;uf;202;30;54;51;55;105;104
ulianopolis;4;uf;758;60;179;75;408;254;320
umari;4;uf;103;7;28;20;44;48;46
umbauba;4;uf;629;46;103;67;350;170;287
umirim;4;uf;611;32;150;101;269;251;270
uniao da vitoria;3;uf;1581;42;390;121;971;511;715
uniao dos palmares;3;uf;1612;79;422;409;583;831;724
unistalda;4;uf;251;4;68;38;134;106;121
upanema;4;uf;102;12;26;21;27;47;50
urai;4;uf;612;13;197;53;331;250;286
urandi;4;uf;2;0;0;0;2;0;1
uruacu;3;uf;3040;110;795;304;1728;1099;1169
uruara;4;uf;76;11;19;7;39;26;23
uruburetama;4;uf;1;0;0;0;0;0;1
urucuca;4;uf;1002;44;235;60;633;295;470
uruguaiana;5;uf;4594;75;1088;312;2963;1400;2012
utinga;4;uf;8;0;5;0;3;5;3
vacaria;5;uf;7912;96;1493;378;5669;1871;3858
vale de sao domingos;4;uf;210;9;58;35;106;93;100
valenca;4;uf;282;28;72;29;141;101;126
valenca do piaui;4;uf;723;48;170;67;418;237;364
valparaiso de goias;5;uf;10737;74;2126;582;7430;2708;4392
valparaiso de goias;5;uf;10737;74;2126;582;7430;2708;4392
vargeao;4;uf;309;12;103;35;152;138;132
vargem;3;uf;2625;57;588;133;1764;721;1395
vargem;3;uf;2625;57;588;133;1764;721;1395
vargem alta;4;uf;4;0;0;0;4;0;2
vargem bonita;3;uf;1856;64;515;188;1059;703;929
vargem grande;4;uf;309;42;69;55;122;124;162
varginha;4;uf;6;0;0;0;6;0;4
varjao;4;uf;430;11;94;47;265;141;219
varjao de minas;4;uf;629;36;228;70;266;298;222
varzea alegre;4;uf;24;6;9;1;7;10;12
varzea da palma;4;uf;454;17;183;50;195;233;175
varzea grande;5;uf;4206;134;973;305;2675;1278;1857
varzedo;4;uf;2;0;1;0;0;1;1
vassouras;3;uf;3101;95;783;286;1837;1069;1435
venda nova do imigrante;3;uf;2575;43;619;322;1475;941;1180
ventania;4;uf;421;20;151;41;196;192;243
venturosa;4;uf;318;35;66;76;116;142;138
vera;4;uf;276;7;81;25;153;106;135
vera cruz;4;uf;13;0;2;0;10;2;8
veranopolis;4;uf;438;3;124;39;259;163;190
verdejante;4;uf;392;22;107;44;199;151;177
vereda;4;uf;33;1;14;6;12;20;12
verissimo;4;uf;29;2;10;5;12;15;15
viamao;4;uf;2;0;0;0;2;0;1
viana;1;uf;11033;147;1850;946;7663;2796;5067
vicencia;4;uf;23;0;0;3;17;3;11
victor graeff;4;uf;176;6;45;8;112;53;82
videira;4;uf;3;0;0;0;3;0;2
vila alta;4;uf;80;0;13;1;65;14;23
vila bela da santissima trindade;4;uf;116;9;39;12;51;51;47
vila boa;4;uf;787;41;266;130;335;396;268
vila flores;4;uf;129;2;36;19;65;55;43
vila nova do mamore;4;uf;39;5;8;3;19;11;18
vila nova do piaui;4;uf;204;17;29;26;127;55;115
vila nova do sul;4;uf;535;11;93;41;381;134;195
vila pavao;4;uf;1;0;0;0;1;0;1
vila propicio;4;uf;518;47;165;105;182;270;197
vila velha;4;uf;1001;19;249;112;557;361;449
vilhena;5;uf;6220;103;1816;597;3526;2413;2774
virginopolis;4;uf;2;0;1;0;1;1;1
virmond;4;uf;579;26;180;54;301;234;295
viseu;4;uf;111;17;27;19;32;46;39
vista serrana;4;uf;35;4;11;4;15;15;21
vitoria;4;uf;950;5;132;41;722;173;353
vitoria da conquista;1;uf;12183;345;3029;651;7627;3680;5359
vitoria das missoes;4;uf;376;27;90;25;232;115;172
vitoria de santo antao;3;uf;2945;73;689;266;1733;955;1385
vitoria do mearim;4;uf;494;44;94;73;232;167;214
vitoria do xingu;4;uf;671;37;173;64;365;237;284
vitorino freire;4;uf;2;0;0;0;2;0;1
volta redonda;5;uf;10125;39;1043;328;8400;1371;4645
wagner;4;uf;13;1;5;0;7;5;6
wanderlandia;3;uf;1681;75;355;184;1001;539;702
wanderley;4;uf;153;6;55;16;74;71;58
wenceslau braz;4;uf;38;2;16;5;14;21;25
wenceslau guimaraes;3;uf;945;58;253;123;452;376;398
xambioa;4;uf;91;7;24;14;45;38;51
xangri-la;4;uf;1;0;0;0;1;0;1
xanxere;3;uf;3704;67;1091;285;2176;1376;1766
xapuri;4;uf;344;16;81;39;190;120;142
xaxim;3;uf;2345;63;681;200;1350;881;1224
xexeu;4;uf;322;16;58;25;199;83;161
xinguara;4;uf;45;2;10;2;28;12;18
ze doca;4;uf;292;54;55;40;113;95;126